,Date,Schl,,Opp,Result,MP,FG,FGA,FG%,2P,2PA,2P%,3P,3PA,3P%,FT,FTA,FT%,PTS
1,2010-11-29,Virginia Military Institute,,Central Pennsylvania College,W 151-92,200,54,94,0.574,33,46,0.717,21,48,0.438,22,34,0.647,151
2,2016-11-13,Citadel,,Johnson University,W 146-84,200,47,106,0.443,30,56,0.536,17,50,0.34,35,41,0.854,146
3,2015-11-14,Butler,,Citadel,W 144-71,200,56,88,0.636,48,62,0.774,8,26,0.308,24,33,0.727,144
4,2016-12-07,Citadel,,Toccoa Falls,W 144-94,200,45,90,0.5,26,44,0.591,19,46,0.413,35,40,0.875,144
5,2012-01-17,Western Carolina,,Toccoa Falls,W 141-39,200,51,88,0.58,42,62,0.677,9,26,0.346,30,37,0.811,141
6,2015-11-13,Chicago State,,Illinois Tech,W 137-59,200,56,91,0.615,48,73,0.658,8,18,0.444,17,31,0.548,137
7,2013-01-03,Southern Mississippi,,Dillard,W 135-41,200,51,90,0.567,33,54,0.611,18,36,0.5,15,16,0.938,135
8,2016-11-11,Troy,,Toccoa Falls,W 135-76,200,51,84,0.607,32,46,0.696,19,38,0.5,14,20,0.7,135
9,2014-12-02,Virginia Military Institute,,Mid-Atlantic Christian,W 133-62,200,54,105,0.514,39,48,0.813,15,57,0.263,10,21,0.476,133
10,2015-11-19,Citadel,,Mid-Atlantic Christian,W 132-60,200,49,73,0.671,30,39,0.769,19,34,0.559,15,23,0.652,132
11,2017-02-09,Wofford,,Samford,W 131-127 (4OT),300,41,92,0.446,28,57,0.491,13,35,0.371,36,44,0.818,131
12,2013-11-08,Charleston Southern,,Johnson University,W 130-51,200,50,72,0.694,37,41,0.902,13,31,0.419,17,19,0.895,130
13,2016-11-20,Iowa State,,Citadel,W 130-63,200,52,86,0.605,44,64,0.688,8,22,0.364,18,26,0.692,130
14,2017-02-04,Eastern Washington,,Portland State,W 130-124 (3OT),275,44,78,0.564,36,58,0.621,8,20,0.4,34,43,0.791,130
15,2013-11-08,Utah,,Evergreen State,W 128-44,200,42,66,0.636,34,48,0.708,8,18,0.444,36,48,0.75,128
16,2014-01-04,Virginia Military Institute,,Washington College,W 128-54,200,43,68,0.632,29,42,0.69,14,26,0.538,28,33,0.848,128
17,2014-12-15,Lamar,,Champion Baptist,W 128-54,200,56,87,0.644,51,70,0.729,5,17,0.294,11,17,0.647,128
18,2015-12-22,San Jose State,,Life Pacific,W 128-66,200,44,76,0.579,35,58,0.603,9,18,0.5,31,35,0.886,128
19,2016-11-11,Weber State,,Antelope Valley,W 128-65,200,48,69,0.696,32,45,0.711,16,24,0.667,16,23,0.696,128
20,2016-12-03,Oregon,,Savannah State,W 128-59,200,54,90,0.6,42,55,0.764,12,35,0.343,8,11,0.727,128
21,2012-11-10,Northern Colorado,,University of the Southwest,W 127-81,200,47,66,0.712,36,46,0.783,11,20,0.55,22,32,0.688,127
22,2014-01-03,Central Michigan,,Marygrove,W 127-44,200,47,74,0.635,35,53,0.66,12,21,0.571,21,26,0.808,127
23,2015-12-18,Idaho,,New Hope Christian,W 127-54,200,53,89,0.596,34,46,0.739,19,43,0.442,2,2,1,127
24,2016-11-23,Arizona State,,Citadel,W 127-110,200,42,78,0.538,27,47,0.574,15,31,0.484,28,37,0.757,127
25,2017-02-09,Samford,@,Wofford,L 127-131 (4OT),300,43,82,0.524,29,55,0.527,14,27,0.519,27,32,0.844,127
26,2010-11-24,Texas State,,Our Lady of the Lake,L 126-127 (OT),225,43,82,0.524,36,63,0.571,7,19,0.368,33,55,0.6,126
27,2011-11-16,North Carolina-Asheville,,Mars Hill,W 126-75,200,49,86,0.57,38,61,0.623,11,25,0.44,17,25,0.68,126
28,2013-12-19,Elon,,Central Pennsylvania College,W 126-78,200,51,87,0.586,42,60,0.7,9,27,0.333,15,18,0.833,126
29,2014-01-04,Louisiana Tech,,Longwood,W 126-52,200,42,76,0.553,25,41,0.61,17,35,0.486,25,32,0.781,126
30,2014-11-26,Iona,,Delaware State,W 126-76,200,41,71,0.577,17,32,0.531,24,39,0.615,20,22,0.909,126
31,2015-11-15,Eastern Washington,,George Fox,W 126-64,200,50,79,0.633,41,54,0.759,9,25,0.36,17,27,0.63,126
32,2016-01-02,IPFW,,Purdue North Central,W 126-95,200,52,72,0.722,40,54,0.741,12,18,0.667,10,13,0.769,126
33,2016-12-03,North Carolina-Wilmington,,Pfeiffer,W 126-113,200,42,70,0.6,32,48,0.667,10,22,0.455,32,49,0.653,126
34,2016-12-21,Lamar,,Arlington Baptist,W 126-75,200,46,78,0.59,34,51,0.667,12,27,0.444,22,31,0.71,126
35,2017-01-05,Lipscomb,,Fisk,W 126-43,200,41,77,0.532,19,28,0.679,22,49,0.449,22,30,0.733,126
36,2010-12-20,Coastal Carolina,,Thomas More,W 125-70,200,47,73,0.644,34,50,0.68,13,23,0.565,18,26,0.692,125
37,2015-01-02,Central Michigan,,Central Pennsylvania College,W 125-80,200,48,84,0.571,32,46,0.696,16,38,0.421,13,17,0.765,125
38,2015-11-19,Gardner-Webb,,Toccoa Falls,W 125-79,200,50,77,0.649,39,55,0.709,11,22,0.5,14,22,0.636,125
39,2015-12-13,Milwaukee,,Judson,W 125-74,200,47,75,0.627,37,57,0.649,10,18,0.556,21,28,0.75,125
40,2016-02-01,Chattanooga,,Citadel,W 125-85,200,39,71,0.549,29,40,0.725,10,31,0.323,37,47,0.787,125
41,2011-12-28,Nevada-Las Vegas,,Central Arkansas,W 124-75,200,47,70,0.671,29,38,0.763,18,32,0.563,12,15,0.8,124
42,2013-12-28,Utah,,St. Katherine,W 124-51,200,49,73,0.671,40,52,0.769,9,21,0.429,17,22,0.773,124
43,2014-02-22,Abilene Christian,,Southwestern Adventist,W 124-57,200,49,79,0.62,28,45,0.622,21,34,0.618,5,8,0.625,124
44,2014-11-18,Virginia Military Institute,,Johnson University,W 124-42,200,43,82,0.524,22,36,0.611,21,46,0.457,17,24,0.708,124
45,2017-01-03,Jacksonville,,Middle Georgia State,W 124-85,200,46,77,0.597,25,43,0.581,21,34,0.618,11,12,0.917,124
46,2017-02-04,Portland State,@,Eastern Washington,L 124-130 (3OT),275,45,84,0.536,34,58,0.586,11,26,0.423,23,36,0.639,124
47,2010-12-11,Lamar,,Huston-Tillotson,W 123-79,200,40,80,0.5,30,58,0.517,10,22,0.455,33,39,0.846,123
48,2012-01-12,Houston Baptist,,Crowley's Ridge,W 123-43,200,49,86,0.57,43,70,0.614,6,16,0.375,19,22,0.864,123
49,2014-11-18,North Carolina Central,,College of Faith,W 123-65,200,44,70,0.629,35,54,0.648,9,16,0.563,26,38,0.684,123
50,2015-11-23,Kansas,N,Chaminade,W 123-72,200,47,73,0.644,32,44,0.727,15,29,0.517,14,20,0.7,123
51,2015-12-27,Radford,,Central Pennsylvania College,W 123-63,200,51,85,0.6,40,55,0.727,11,30,0.367,10,12,0.833,123
52,2010-12-13,South Dakota,,Tabor College,W 122-71,200,47,73,0.644,36,50,0.72,11,23,0.478,17,24,0.708,122
53,2011-12-10,Virginia Military Institute,,Milligan,W 122-73,200,38,59,0.644,26,34,0.765,12,25,0.48,34,47,0.723,122
54,2013-11-13,Holy Cross,,Sacred Heart,W 122-118 (2OT),250,33,70,0.471,22,47,0.468,11,23,0.478,45,56,0.804,122
55,2013-12-28,Charleston Southern,,St. Andrews,W 122-40,200,38,57,0.667,18,24,0.75,20,33,0.606,26,34,0.765,122
56,2015-11-23,Detroit Mercy,,Michigan-Dearborn,W 122-70,200,39,68,0.574,24,41,0.585,15,27,0.556,29,39,0.744,122
57,2016-01-02,Tennessee-Martin,,Boyce,W 122-60,200,44,78,0.564,28,38,0.737,16,40,0.4,18,24,0.75,122
58,2010-11-23,Saint Mary's (CA),,Chicago State,W 121-52,200,43,74,0.581,30,42,0.714,13,32,0.406,22,28,0.786,121
59,2013-11-16,Virginia Military Institute,,Bluefield State,W 121-80,200,38,81,0.469,21,45,0.467,17,36,0.472,28,35,0.8,121
60,2013-12-17,Marshall,,Alice Lloyd,W 121-57,200,44,68,0.647,29,42,0.69,15,26,0.577,18,22,0.818,121
61,2013-12-30,Central Arkansas,,Ecclesia,W 121-77,200,50,89,0.562,45,68,0.662,5,21,0.238,16,26,0.615,121
62,2014-11-25,Brigham Young,N,Chaminade,W 121-85,200,41,74,0.554,24,45,0.533,17,29,0.586,22,26,0.846,121
63,2014-11-29,Morehead State,,Kentucky Christian,W 121-49,200,49,77,0.636,39,57,0.684,10,20,0.5,13,26,0.5,121
64,2015-11-27,Citadel,N,Bob Jones University,W 121-81,213,46,89,0.517,33,55,0.6,13,34,0.382,16,23,0.696,121
65,2016-01-16,Dartmouth,,Pine Manor,W 121-56,200,50,79,0.633,45,61,0.738,5,18,0.278,16,19,0.842,121
66,2010-11-16,Virginia Military Institute,,Virginia Wise,W 120-88,200,37,83,0.446,25,46,0.543,12,37,0.324,34,38,0.895,120
67,2010-11-30,Charleston Southern,,Toccoa Falls,W 120-43,200,51,86,0.593,38,63,0.603,13,23,0.565,5,5,1,120
68,2010-12-28,Arkansas State,,Central Baptist,W 120-39,200,39,64,0.609,26,38,0.684,13,26,0.5,29,39,0.744,120
69,2012-12-05,Cal State Northridge,,Vanguard,W 120-69,200,45,67,0.672,35,51,0.686,10,16,0.625,20,25,0.8,120
70,2012-12-11,Saint Mary's (CA),,Jackson State,W 120-67,200,39,63,0.619,26,40,0.65,13,23,0.565,29,35,0.829,120
71,2013-12-19,Morehead State,,South Dakota,W 120-83,200,44,80,0.55,27,48,0.563,17,32,0.531,15,20,0.75,120
72,2016-03-16,Duquesne,,Nebraska-Omaha,W 120-112,200,37,59,0.627,25,35,0.714,12,24,0.5,34,44,0.773,120
73,2016-11-29,Florida Gulf Coast,,Ave Maria,W 120-60,200,47,70,0.671,36,49,0.735,11,21,0.524,15,19,0.789,120
74,2016-12-19,Maryland-Baltimore County,,Citadel,W 120-111 (2OT),250,38,80,0.475,31,59,0.525,7,21,0.333,37,49,0.755,120
75,2016-12-28,Morehead State,,Asbury,W 120-77,200,52,94,0.553,49,78,0.628,3,16,0.188,13,24,0.542,120
76,2013-11-08,Chattanooga,,Covenant,W 119-56,200,42,75,0.56,36,56,0.643,6,19,0.316,29,37,0.784,119
77,2013-11-12,Marshall,,Rio Grande,W 119-77,200,45,72,0.625,36,54,0.667,9,18,0.5,20,33,0.606,119
78,2014-03-06,Northwestern State,,Central Arkansas,W 119-102,200,40,67,0.597,30,51,0.588,10,16,0.625,29,40,0.725,119
79,2014-12-28,Radford,,Central Pennsylvania College,W 119-69,200,47,67,0.701,37,52,0.712,10,15,0.667,15,23,0.652,119
80,2015-11-27,Auburn,,Northwestern State,W 119-81,200,43,74,0.581,26,42,0.619,17,32,0.531,16,23,0.696,119
81,2015-12-02,Louisiana State,,North Florida,W 119-108,200,45,70,0.643,42,58,0.724,3,12,0.25,26,36,0.722,119
82,2015-12-09,Nevada,,Fresno Pacific,W 119-70,200,40,67,0.597,27,43,0.628,13,24,0.542,26,34,0.765,119
83,2016-11-11,UCLA,,Pacific,W 119-80,200,42,69,0.609,24,39,0.615,18,30,0.6,17,24,0.708,119
84,2016-11-15,Citadel,,Truett-McConnell,W 119-90,200,37,85,0.435,22,37,0.595,15,48,0.313,30,40,0.75,119
85,2016-11-17,Appalachian State,,Warren Wilson,W 119-51,200,40,70,0.571,28,42,0.667,12,28,0.429,27,34,0.794,119
86,2016-11-19,Saint Francis (PA),,Chatham,W 119-59,200,44,73,0.603,25,41,0.61,19,32,0.594,12,21,0.571,119
87,2016-12-17,Cincinnati,,Fairleigh Dickinson,W 119-68,200,44,68,0.647,32,43,0.744,12,25,0.48,19,29,0.655,119
88,2016-12-19,Sam Houston State,,Hillsdale,W 119-81,200,41,72,0.569,31,50,0.62,10,22,0.455,27,33,0.818,119
89,2010-11-13,Washington,,McNeese State,W 118-64,200,43,92,0.467,31,62,0.5,12,30,0.4,20,42,0.476,118
90,2010-11-27,Lamar,,St. Gregory's,W 118-69,200,45,87,0.517,39,67,0.582,6,20,0.3,22,30,0.733,118
91,2011-11-11,Cal State Fullerton,,Redlands,W 118-68,200,41,74,0.554,30,47,0.638,11,27,0.407,25,39,0.641,118
92,2011-12-31,Duquesne,,Houston Baptist,W 118-72,200,44,76,0.579,36,59,0.61,8,17,0.471,22,34,0.647,118
93,2012-11-09,Northwestern State,,East Texas Baptist,W 118-77,200,48,76,0.632,38,52,0.731,10,24,0.417,12,21,0.571,118
94,2013-02-20,Louisiana Tech,,Central Baptist,W 118-48,200,47,94,0.5,32,53,0.604,15,41,0.366,9,12,0.75,118
95,2013-11-11,Southeast Missouri State,,Central Baptist,W 118-55,200,45,81,0.556,28,46,0.609,17,35,0.486,11,15,0.733,118
96,2013-11-13,Sacred Heart,@,Holy Cross,L 118-122 (2OT),250,38,76,0.5,28,50,0.56,10,26,0.385,32,38,0.842,118
97,2013-12-14,Coastal Carolina,,Reinhardt,W 118-82,200,42,62,0.677,31,46,0.674,11,16,0.688,23,33,0.697,118
98,2013-12-27,San Diego State,,St. Katherine,W 118-35,200,43,70,0.614,29,48,0.604,14,22,0.636,18,32,0.563,118
99,2014-01-04,Iona,,Niagara,W 118-92,200,40,62,0.645,26,36,0.722,14,26,0.538,24,35,0.686,118
100,2014-03-01,Southeast Missouri State,,Murray State,W 118-115 (2OT),250,44,78,0.564,36,57,0.632,8,21,0.381,22,29,0.759,118
101,2016-11-21,Savannah State,,Fort Valley State,W 118-101,200,40,74,0.541,17,29,0.586,23,45,0.511,15,23,0.652,118
102,2016-12-08,Florida State,,Nicholls State,W 118-63,200,45,72,0.625,28,40,0.7,17,32,0.531,11,12,0.917,118
103,2016-12-22,Portland State,,Walla Walla,W 118-59,200,45,77,0.584,24,38,0.632,21,39,0.538,7,9,0.778,118
104,2010-11-12,Gonzaga,,Southern,W 117-72,200,39,72,0.542,26,50,0.52,13,22,0.591,26,33,0.788,117
105,2012-11-09,Xavier,,Fairleigh Dickinson,W 117-75,200,43,61,0.705,30,40,0.75,13,21,0.619,18,21,0.857,117
106,2013-11-08,Oklahoma State,,Mississippi Valley State,W 117-62,200,38,62,0.613,26,41,0.634,12,21,0.571,29,41,0.707,117
107,2013-11-29,Mercer,@,Valparaiso,W 117-108 (3OT),275,36,78,0.462,26,57,0.456,10,21,0.476,35,41,0.854,117
108,2014-12-07,Elon,,Central Pennsylvania College,W 117-73,200,47,77,0.61,35,50,0.7,12,27,0.444,11,18,0.611,117
109,2015-12-01,Arkansas,,Northwestern State,W 117-78,200,44,79,0.557,38,64,0.594,6,15,0.4,23,30,0.767,117
110,2015-12-12,North Florida,,Coastal Georgia,W 117-71,200,37,60,0.617,23,31,0.742,14,29,0.483,29,42,0.69,117
111,2016-11-11,Central Michigan,,Indiana-Kokomo,W 117-53,200,33,75,0.44,23,41,0.561,10,34,0.294,41,50,0.82,117
112,2016-11-13,IPFW,,Kenyon,W 117-60,200,40,65,0.615,29,45,0.644,11,20,0.55,26,28,0.929,117
113,2016-11-15,Wofford,,Allen,W 117-77,200,42,62,0.677,25,36,0.694,17,26,0.654,16,22,0.727,117
114,2016-11-16,Oklahoma State,,New Orleans,W 117-72,201,38,71,0.535,27,46,0.587,11,25,0.44,30,38,0.789,117
115,2016-11-17,Louisiana-Lafayette,,Panhandle State,W 117-47,200,49,76,0.645,40,49,0.816,9,27,0.333,10,17,0.588,117
116,2016-12-10,North Carolina-Asheville,,Warren Wilson,W 117-52,200,40,70,0.571,28,47,0.596,12,23,0.522,25,38,0.658,117
117,2016-12-11,Eastern Michigan,,Siena Heights,W 117-55,200,43,72,0.597,37,57,0.649,6,15,0.4,25,32,0.781,117
118,2016-12-15,Auburn,,Coastal Carolina,W 117-72,200,40,72,0.556,19,30,0.633,21,42,0.5,16,22,0.727,117
119,2010-11-20,North Carolina-Asheville,,Virginia Intermont,W 116-58,200,44,80,0.55,32,54,0.593,12,26,0.462,16,19,0.842,116
120,2010-12-18,Missouri,,Central Arkansas,W 116-63,200,45,68,0.662,32,42,0.762,13,26,0.5,13,16,0.813,116
121,2011-11-13,Troy,,LaGrange,W 116-63,200,41,93,0.441,24,57,0.421,17,36,0.472,17,21,0.81,116
122,2012-11-13,Virginia Military Institute,,Central Pennsylvania College,W 116-81,200,45,85,0.529,32,52,0.615,13,33,0.394,13,20,0.65,116
123,2012-11-15,UC-Irvine,,Pacifica,W 116-47,200,42,68,0.618,30,47,0.638,12,21,0.571,20,29,0.69,116
124,2013-11-08,Boise State,,Texas-Arlington,W 116-87,200,41,71,0.577,28,45,0.622,13,26,0.5,21,28,0.75,116
125,2013-11-11,Sam Houston State,,Hillsdale Baptist/Randall (Ok.),W 116-54,200,45,79,0.57,28,48,0.583,17,31,0.548,9,15,0.6,116
126,2013-11-25,Rutgers,,Stillman,W 116-89,200,41,68,0.603,30,46,0.652,11,22,0.5,23,30,0.767,116
127,2013-12-14,Northwestern State,,Louisiana College,W 116-76,200,48,80,0.6,41,67,0.612,7,13,0.538,13,20,0.65,116
128,2013-12-30,Southern,,Champion Baptist,W 116-12,200,46,78,0.59,40,62,0.645,6,16,0.375,18,33,0.545,116
129,2014-03-14,Arkansas State,N,Arkansas-Little Rock,W 116-114 (4OT),300,35,79,0.443,22,51,0.431,13,28,0.464,33,47,0.702,116
130,2014-11-14,Indiana,,Mississippi Valley State,W 116-65,200,39,59,0.661,28,36,0.778,11,23,0.478,27,37,0.73,116
131,2014-11-15,Evansville,,Earlham (IN),W 116-45,200,50,80,0.625,47,74,0.635,3,6,0.5,13,17,0.765,116
132,2015-11-13,Georgia Southern,,Webber,W 116-49,200,41,83,0.494,26,43,0.605,15,40,0.375,19,33,0.576,116
133,2015-11-13,Georgia Tech,,Cornell,W 116-81,200,47,78,0.603,39,55,0.709,8,23,0.348,14,23,0.609,116
134,2015-11-18,Presbyterian,,Toccoa Falls,W 116-75,200,45,84,0.536,42,61,0.689,3,23,0.13,23,36,0.639,116
135,2015-11-21,Coastal Carolina,,Piedmont,W 116-35,200,43,70,0.614,30,39,0.769,13,31,0.419,17,25,0.68,116
136,2015-12-08,Texas,,Texas-San Antonio,W 116-50,200,44,68,0.647,29,38,0.763,15,30,0.5,13,22,0.591,116
137,2015-12-22,Alabama-Birmingham,,Hiwassee,W 116-43,200,45,71,0.634,38,56,0.679,7,15,0.467,19,20,0.95,116
138,2015-12-28,Winthrop,,Rio Grande,W 116-84,200,45,72,0.625,33,43,0.767,12,29,0.414,14,19,0.737,116
139,2016-11-13,Iowa,,Savannah State,W 116-84,200,42,87,0.483,24,44,0.545,18,43,0.419,14,20,0.7,116
140,2016-11-18,Citadel,@,Stetson,W 116-112,200,39,81,0.481,21,40,0.525,18,41,0.439,20,29,0.69,116
141,2016-11-20,Wichita State,,Maryland-Eastern Shore,W 116-79,200,35,53,0.66,20,29,0.69,15,24,0.625,31,43,0.721,116
142,2016-11-22,Houston Baptist,,Ecclesia,W 116-80,200,41,80,0.513,27,51,0.529,14,29,0.483,20,25,0.8,116
143,2016-12-06,Wofford,,Virginia Wise,W 116-56,200,45,64,0.703,30,42,0.714,15,22,0.682,11,15,0.733,116
144,2016-12-11,Appalachian State,,Montreat,W 116-57,200,40,66,0.606,24,33,0.727,16,33,0.485,20,30,0.667,116
145,2017-03-06,Kent State,,Central Michigan,W 116-106 (OT),225,40,84,0.476,24,53,0.453,16,31,0.516,20,27,0.741,116
146,2010-11-12,Central Florida,,West Florida,W 115-61,200,40,60,0.667,30,36,0.833,10,24,0.417,25,39,0.641,115
147,2010-11-12,Lamar,,Lyon,W 115-57,200,40,76,0.526,25,41,0.61,15,35,0.429,20,33,0.606,115
148,2011-11-13,North Carolina Central,,Johnson & Wales (NC),W 115-41,200,43,66,0.652,34,42,0.81,9,24,0.375,20,28,0.714,115
149,2012-01-25,Texas-San Antonio,,Jarvis Christian,W 115-49,200,41,67,0.612,24,36,0.667,17,31,0.548,16,22,0.727,115
150,2012-02-23,New Mexico State,,Hawaii,W 115-73,200,41,68,0.603,36,54,0.667,5,14,0.357,28,43,0.651,115
151,2013-11-13,Norfolk State,,Newberry,W 115-95,200,41,68,0.603,34,51,0.667,7,17,0.412,26,35,0.743,115
152,2013-12-08,Oregon,@,Mississippi,W 115-105 (OT),225,38,65,0.585,27,47,0.574,11,18,0.611,28,35,0.8,115
153,2013-12-09,Middle Tennessee,,Fisk,W 115-65,200,42,68,0.618,35,46,0.761,7,22,0.318,24,37,0.649,115
154,2014-03-01,Murray State,@,Southeast Missouri State,L 115-118 (2OT),250,35,73,0.479,21,43,0.488,14,30,0.467,31,39,0.795,115
155,2014-11-14,Georgia State,,Tennessee Temple,W 115-55,200,40,64,0.625,27,43,0.628,13,21,0.619,22,35,0.629,115
156,2014-11-18,Eastern Kentucky,,Kentucky Christian,W 115-35,200,44,72,0.611,28,44,0.636,16,28,0.571,11,15,0.733,115
157,2014-11-20,Tennessee-Martin,,Champion Baptist,W 115-29,200,43,71,0.606,29,42,0.69,14,29,0.483,15,22,0.682,115
158,2014-11-22,Eastern Kentucky,,Cincinnati-Clermont,W 115-50,200,41,78,0.526,30,43,0.698,11,35,0.314,22,28,0.786,115
159,2014-12-13,Louisiana-Lafayette,,Centenary (LA),W 115-59,200,44,74,0.595,28,48,0.583,16,26,0.615,11,21,0.524,115
160,2014-12-17,Louisiana-Lafayette,,Milligan,W 115-76,200,42,74,0.568,31,49,0.633,11,25,0.44,20,31,0.645,115
161,2015-12-22,Maryland-Eastern Shore,,Central Pennsylvania College,W 115-86,200,42,62,0.677,33,44,0.75,9,18,0.5,22,32,0.688,115
162,2015-12-28,Utah,,College of Idaho,W 115-74,200,42,67,0.627,31,42,0.738,11,25,0.44,20,31,0.645,115
163,2016-01-25,Green Bay,,Detroit Mercy,W 115-108 (OT),225,37,75,0.493,29,54,0.537,8,21,0.381,33,49,0.673,115
164,2016-02-27,Ball State,,Eastern Michigan,W 115-79,200,38,69,0.551,20,30,0.667,18,39,0.462,21,29,0.724,115
165,2016-11-11,Texas A&M-Corpus Christi,,Our Lady of the Lake,W 115-100,200,37,66,0.561,30,49,0.612,7,17,0.412,34,45,0.756,115
166,2016-11-28,Kentucky,N,Arizona State,W 115-69,200,44,83,0.53,33,55,0.6,11,28,0.393,16,22,0.727,115
167,2017-01-05,East Tennessee State,@,Citadel,W 115-71,200,42,77,0.545,32,54,0.593,10,23,0.435,21,35,0.6,115
168,2017-01-09,IPFW,,Olivet,W 115-60,200,43,71,0.606,22,31,0.71,21,40,0.525,8,12,0.667,115
169,2010-11-12,Stephen F. Austin,,Howard Payne,W 114-49,200,37,75,0.493,29,56,0.518,8,19,0.421,32,46,0.696,114
170,2010-11-14,DePaul,,Chicago State,W 114-81,200,42,71,0.592,37,49,0.755,5,22,0.227,25,34,0.735,114
171,2010-12-11,Virginia Military Institute,,Longwood,W 114-82,200,43,78,0.551,28,44,0.636,15,34,0.441,13,22,0.591,114
172,2010-12-22,Louisville,@,Western Kentucky,W 114-82,200,42,65,0.646,26,35,0.743,16,30,0.533,14,22,0.636,114
173,2011-01-04,Lamar,,Louisiana College,W 114-62,200,40,83,0.482,23,41,0.561,17,42,0.405,17,30,0.567,114
174,2011-12-03,Charleston Southern,,Virginia Military Institute,W 114-81,200,42,69,0.609,29,47,0.617,13,22,0.591,17,20,0.85,114
175,2012-12-30,Morehead State,,Union (KY),W 114-67,200,42,82,0.512,33,61,0.541,9,21,0.429,21,29,0.724,114
176,2013-02-23,Cal State Bakersfield,,Pacifica,W 114-66,200,44,84,0.524,35,54,0.648,9,30,0.3,17,20,0.85,114
177,2013-11-08,Elon,,Washington & Lee,W 114-64,200,41,57,0.719,29,36,0.806,12,21,0.571,20,23,0.87,114
178,2013-11-12,Marquette,,Grambling,W 114-71,200,45,82,0.549,40,64,0.625,5,18,0.278,19,31,0.613,114
179,2013-11-13,Eastern Kentucky,,Warren Wilson,W 114-45,200,40,65,0.615,20,26,0.769,20,39,0.513,14,21,0.667,114
180,2013-11-21,Hawaii,,Hawaii-Hilo,W 114-63,200,47,75,0.627,40,57,0.702,7,18,0.389,13,22,0.591,114
181,2014-01-23,Portland,,Brigham Young,W 114-110 (3OT),275,37,78,0.474,23,55,0.418,14,23,0.609,26,41,0.634,114
182,2014-03-14,Arkansas-Little Rock,N,Arkansas State,L 114-116 (4OT),300,36,89,0.404,28,68,0.412,8,21,0.381,34,40,0.85,114
183,2014-11-16,Illinois,,Coppin State,W 114-56,200,41,74,0.554,26,46,0.565,15,28,0.536,17,19,0.895,114
184,2014-12-16,Southern,,Champion Baptist,W 114-50,200,47,73,0.644,43,65,0.662,4,8,0.5,16,19,0.842,114
185,2015-11-17,Sam Houston State,,St. Thomas (TX),W 114-92,200,30,57,0.526,25,41,0.61,5,16,0.313,49,64,0.766,114
186,2015-12-28,Weber State,,Multnomah,W 114-47,200,43,68,0.632,24,32,0.75,19,36,0.528,9,11,0.818,114
187,2016-02-11,Brigham Young,@,San Francisco,W 114-89,200,38,66,0.576,21,39,0.538,17,27,0.63,21,30,0.7,114
188,2016-02-25,Charlotte,,Texas-San Antonio,W 114-108 (2OT),250,36,67,0.537,27,44,0.614,9,23,0.391,33,39,0.846,114
189,2016-11-20,UCLA,,Long Beach State,W 114-77,200,46,71,0.648,34,51,0.667,12,20,0.6,10,11,0.909,114
190,2016-11-26,Utah Valley,@,Brigham Young,W 114-101,200,36,68,0.529,18,31,0.581,18,37,0.486,24,32,0.75,114
191,2016-12-14,Troy,N,Point University,W 114-52,200,42,72,0.583,32,47,0.681,10,25,0.4,20,27,0.741,114
192,2017-01-14,Hawaii,,Long Beach State,W 114-107 (OT),225,37,61,0.607,26,33,0.788,11,28,0.393,29,40,0.725,114
193,2017-02-14,Florida,@,Auburn,W 114-95,200,33,59,0.559,22,40,0.55,11,19,0.579,37,42,0.881,114
194,2010-11-12,Kansas,,Longwood,W 113-75,200,43,69,0.623,35,50,0.7,8,19,0.421,19,27,0.704,113
195,2010-12-16,Tennessee Tech,N,Hiwassee,W 113-42,200,44,74,0.595,38,58,0.655,6,16,0.375,19,36,0.528,113
196,2011-02-24,Longwood,,Washington Adventist,W 113-84,200,43,69,0.623,37,50,0.74,6,19,0.316,21,27,0.778,113
197,2011-03-02,Lamar,,Texas State,W 113-102,200,40,78,0.513,27,51,0.529,13,27,0.481,20,27,0.741,113
198,2011-11-14,Maine,,Maine-Machias,W 113-49,200,44,63,0.698,30,36,0.833,14,27,0.519,11,13,0.846,113
199,2011-11-14,NJIT,,Penn State-Abington,W 113-61,200,43,76,0.566,33,50,0.66,10,26,0.385,17,22,0.773,113
200,2011-11-18,Detroit Mercy,,Concordia (MI),W 113-68,200,44,79,0.557,35,56,0.625,9,23,0.391,16,27,0.593,113
201,2013-11-10,Valparaiso,,North Park,W 113-50,200,40,57,0.702,28,39,0.718,12,18,0.667,21,27,0.778,113
202,2013-11-11,Texas Southern,,Wiley,W 113-96,200,38,69,0.551,27,42,0.643,11,27,0.407,26,30,0.867,113
203,2013-11-26,Gonzaga,@,Chaminade,W 113-81,200,46,66,0.697,33,43,0.767,13,23,0.565,8,11,0.727,113
204,2013-12-07,Louisville,,Louisiana-Lafayette,W 113-74,200,38,62,0.613,34,44,0.773,4,18,0.222,33,40,0.825,113
205,2014-11-14,Duke,,Presbyterian,W 113-44,200,42,69,0.609,26,38,0.684,16,31,0.516,13,16,0.813,113
206,2014-11-14,UCLA,,Montana State,W 113-78,200,39,68,0.574,30,49,0.612,9,19,0.474,26,40,0.650,113
207,2014-12-05,Nevada-Las Vegas,,St. Katherine,W 113-53,200,41,66,0.621,28,44,0.636,13,22,0.591,18,28,0.643,113
208,2015-02-21,Virginia Military Institute,@,Western Carolina,W 113-111 (2OT),250,34,74,0.459,14,28,0.500,20,46,0.435,25,32,0.781,113
209,2015-11-14,Duke,,Bryant,W 113-75,200,39,73,0.534,26,47,0.553,13,26,0.500,22,29,0.759,113
210,2015-11-16,South Carolina State,,Voorhees,W 113-69,200,35,66,0.530,24,42,0.571,11,24,0.458,32,44,0.727,113
211,2015-11-24,Fairfield,@,Maryland-Eastern Shore,W 113-74,200,41,72,0.569,24,31,0.774,17,41,0.415,14,20,0.700,113
212,2016-11-11,Iowa State,,Savannah State,W 113-71,200,47,85,0.553,39,59,0.661,8,26,0.308,11,20,0.550,113
213,2016-11-17,Portland State,,George Fox,W 113-81,200,38,58,0.655,31,38,0.816,7,20,0.350,30,45,0.667,113
214,2016-12-09,Creighton,,Longwood,W 113-58,200,41,70,0.586,29,48,0.604,12,22,0.545,19,28,0.679,113
215,2016-12-16,William & Mary,,Milligan,W 113-59,200,40,66,0.606,27,38,0.711,13,28,0.464,20,27,0.741,113
216,2016-12-17,Virginia Tech,,Citadel,W 113-71,200,42,69,0.609,31,51,0.608,11,18,0.611,18,26,0.692,113
217,2010-11-12,Coastal Carolina,,Piedmont,W 112-52,200,43,69,0.623,35,48,0.729,8,21,0.381,18,27,0.667,112
218,2010-12-04,Eastern Washington,,New Hope Christian,W 112-41,200,45,77,0.584,27,34,0.794,18,43,0.419,4,6,0.667,112
219,2010-12-11,Austin Peay,,Fontbonne,W 112-52,200,43,75,0.573,35,52,0.673,8,23,0.348,18,24,0.750,112
220,2010-12-18,St. Bonaventure,,Ohio,W 112-107 (4OT),300,38,67,0.567,32,49,0.653,6,18,0.333,30,48,0.625,112
221,2011-11-23,North Carolina Central,,Morris College,W 112-50,200,39,57,0.684,30,38,0.789,9,19,0.474,25,32,0.781,112
222,2011-12-10,Houston Baptist,,Dallas Christian,W 112-80,200,41,84,0.488,35,64,0.547,6,20,0.300,24,31,0.774,112
223,2012-11-17,Cal State Fullerton,N,Southern Utah,W 112-69,200,37,57,0.649,25,40,0.625,12,17,0.706,26,35,0.743,112
224,2012-11-18,Arkansas,,Longwood,W 112-63,200,43,82,0.524,38,61,0.623,5,21,0.238,21,32,0.656,112
225,2012-11-21,North Carolina,@,Chaminade,W 112-70,200,43,69,0.623,30,42,0.714,13,27,0.481,13,21,0.619,112
226,2012-12-18,Yale,,Albertus Magnus,W 112-63,200,42,65,0.646,32,47,0.681,10,18,0.556,18,26,0.692,112
227,2013-02-23,Marist,,Virginia Military Institute,W 112-74,200,41,64,0.641,29,43,0.674,12,21,0.571,18,27,0.667,112
228,2013-03-20,Baylor,,Long Beach State,W 112-66,200,40,63,0.635,24,40,0.600,16,23,0.696,16,25,0.640,112
229,2013-11-11,Brigham Young,@,Stanford,W 112-103,200,38,71,0.535,30,56,0.536,8,15,0.533,28,43,0.651,112
230,2013-11-20,Virginia Military Institute,,Bridgewater (VA),W 112-86,200,44,91,0.484,34,58,0.586,10,33,0.303,14,19,0.737,112
231,2013-11-30,South Dakota,,Graceland (IA),W 112-85,200,42,73,0.575,29,44,0.659,13,29,0.448,15,27,0.556,112
232,2013-12-19,Tennessee Tech,,Hillsdale Baptist/Randall (Ok.),W 112-56,200,40,83,0.482,31,60,0.517,9,23,0.391,23,32,0.719,112
233,2014-01-02,IUPUI,,Judson,W 112-50,200,42,74,0.568,35,59,0.593,7,15,0.467,21,23,0.913,112
234,2015-01-10,Columbia,,Central Pennsylvania College,W 112-63,200,37,69,0.536,21,34,0.618,16,35,0.457,22,26,0.846,112
235,2015-11-13,North Texas,,Jarvis Christian,W 112-82,200,37,71,0.521,28,50,0.560,9,21,0.429,29,54,0.537,112
236,2015-11-25,Oral Roberts,,Tabor College,W 112-80,200,37,70,0.529,25,42,0.595,12,28,0.429,26,37,0.703,112
237,2015-11-30,Indiana,,Alcorn State,W 112-70,200,39,58,0.672,24,32,0.750,15,26,0.577,19,25,0.760,112
238,2015-12-30,Austin Peay,,Westminster (MO),W 112-61,200,45,76,0.592,38,59,0.644,7,17,0.412,15,22,0.682,112
239,2016-01-28,Eastern Washington,,Portland State,W 112-83,200,37,58,0.638,17,27,0.630,20,31,0.645,18,27,0.667,112
240,2016-02-04,Texas-El Paso,,Marshall,W 112-108,200,37,66,0.561,26,48,0.542,11,18,0.611,27,37,0.730,112
241,2016-02-06,Central Arkansas,,New Orleans,W 112-77,200,41,66,0.621,32,42,0.762,9,24,0.375,21,25,0.840,112
242,2016-03-16,Nebraska-Omaha,@,Duquesne,L 112-120,200,34,80,0.425,19,45,0.422,15,35,0.429,29,36,0.806,112
243,2016-11-15,Illinois,,McKendree,W 112-65,200,44,79,0.557,28,51,0.549,16,28,0.571,8,13,0.615,112
244,2016-11-18,Stetson,,Citadel,L 112-116,200,39,74,0.527,30,52,0.577,9,22,0.409,25,34,0.735,112
245,2016-11-20,Creighton,N,North Carolina State,W 112-94,200,40,66,0.606,27,39,0.692,13,27,0.481,19,24,0.792,112
246,2016-11-22,Nebraska-Omaha,,Buena Vista,W 112-65,200,40,69,0.580,24,35,0.686,16,34,0.471,16,27,0.593,112
247,2016-11-22,North Florida,,Florida National University,W 112-66,200,45,72,0.625,37,57,0.649,8,15,0.533,14,25,0.560,112
248,2016-12-17,West Virginia,,Missouri-Kansas City,W 112-67,200,41,77,0.532,30,45,0.667,11,32,0.344,19,27,0.704,112
249,2016-12-19,William & Mary,,Savannah State,W 112-85,200,36,70,0.514,17,26,0.654,19,44,0.432,21,34,0.618,112
250,2016-12-28,Pittsburgh,,Marshall,W 112-106,200,38,73,0.521,28,49,0.571,10,24,0.417,26,37,0.703,112
251,2017-01-14,Sacred Heart,@,Bryant,W 112-110 (3OT),275,39,74,0.527,28,47,0.596,11,27,0.407,23,35,0.657,112
252,2017-01-19,Lipscomb,@,Jacksonville,W 112-95,200,33,49,0.673,25,29,0.862,8,20,0.400,38,52,0.731,112
253,2017-02-11,Rider,,Quinnipiac,W 112-107,200,34,58,0.586,21,39,0.538,13,19,0.684,31,36,0.861,112
254,2010-11-12,Valparaiso,,Indiana-Northwest,W 111-64,200,43,74,0.581,36,51,0.706,7,23,0.304,18,26,0.692,111
255,2010-11-22,Longwood,,Montreat,W 111-62,200,41,77,0.532,28,47,0.596,13,30,0.433,16,21,0.762,111
256,2010-11-26,Iowa,,Southern Illinois-Edwardsville,W 111-50,200,37,63,0.587,27,45,0.600,10,18,0.556,27,38,0.711,111
257,2010-11-30,Georgetown,N,Missouri,W 111-102 (OT),225,39,69,0.565,24,37,0.649,15,32,0.469,18,18,1.000,111
258,2010-12-01,Southeastern Louisiana,,Dillard,W 111-67,200,39,64,0.609,31,48,0.646,8,16,0.500,25,33,0.758,111
259,2011-01-25,Florida Gulf Coast,@,Stetson,W 111-103 (3OT),275,30,61,0.492,20,42,0.476,10,19,0.526,41,60,0.683,111
260,2011-01-27,Chattanooga,,North Carolina-Greensboro,W 111-110 (2OT),250,32,54,0.593,21,31,0.677,11,23,0.478,36,53,0.679,111
261,2011-11-11,Davidson,,Guilford,W 111-64,200,37,76,0.487,26,40,0.650,11,36,0.306,26,36,0.722,111
262,2011-11-13,Montana State,,Northern New Mexico,W 111-61,200,46,72,0.639,40,53,0.755,6,19,0.316,13,21,0.619,111
263,2012-01-04,Buffalo,,Buffalo State,W 111-59,200,39,81,0.481,30,58,0.517,9,23,0.391,24,42,0.571,111
264,2012-02-29,Seattle,,Longwood,W 111-74,200,42,82,0.512,26,46,0.565,16,36,0.444,11,18,0.611,111
265,2012-12-04,East Carolina,,St. Andrews,W 111-59,200,37,73,0.507,19,37,0.514,18,36,0.500,19,27,0.704,111
266,2013-11-08,Duke,,Davidson,W 111-77,200,38,54,0.704,25,33,0.758,13,21,0.619,22,32,0.688,111
267,2013-11-10,Maine,,Fisher College,W 111-64,198,44,74,0.595,34,54,0.630,10,20,0.500,13,21,0.619,111
268,2013-11-13,Texas-Arlington,,Howard Payne,W 111-64,200,40,71,0.563,27,39,0.692,13,32,0.406,18,28,0.643,111
269,2013-11-15,Northwestern State,@,Auburn,W 111-92,200,36,72,0.500,22,45,0.489,14,27,0.519,25,29,0.862,111
270,2013-11-22,Mississippi,,Mississippi Valley State,W 111-82,200,36,71,0.507,27,52,0.519,9,19,0.474,30,38,0.789,111
271,2013-11-24,Northern Illinois,,Saint Joseph's (IN),W 111-61,200,41,81,0.506,35,62,0.565,6,19,0.316,23,32,0.719,111
272,2013-12-03,Arkansas,,Southeastern Louisiana,W 111-65,201,38,61,0.623,29,43,0.674,9,18,0.500,26,34,0.765,111
273,2013-12-04,Radford,,Central Pennsylvania College,W 111-72,200,41,64,0.641,31,46,0.674,10,18,0.556,19,26,0.731,111
274,2014-03-18,Virginia Military Institute,@,Canisius,W 111-100,200,36,72,0.500,27,42,0.643,9,30,0.300,30,34,0.882,111
275,2014-11-18,East Tennessee State,,Virginia Wise,W 111-66,200,42,87,0.483,28,54,0.519,14,33,0.424,13,22,0.591,111
276,2014-11-29,Sam Houston State,,University of the Southwest,W 111-51,200,38,69,0.551,26,39,0.667,12,30,0.400,23,35,0.657,111
277,2014-12-02,Elon,,Virginia-Lynchburg,W 111-55,200,41,88,0.466,28,55,0.509,13,33,0.394,16,22,0.727,111
278,2015-02-21,Western Carolina,,Virginia Military Institute,L 111-113 (2OT),250,40,79,0.506,33,57,0.579,7,22,0.318,24,34,0.706,111
279,2015-11-16,Fairleigh Dickinson,,Fairleigh Dickinson-Florham,W 111-70,200,48,79,0.608,43,62,0.694,5,17,0.294,10,14,0.714,111
280,2015-12-03,Oklahoma,,Central Arkansas,W 111-68,200,36,69,0.522,23,47,0.489,13,22,0.591,26,35,0.743,111
281,2015-12-05,Louisville,,Grand Canyon,W 111-63,200,38,70,0.543,28,48,0.583,10,22,0.455,25,36,0.694,111
282,2015-12-13,High Point,,Virginia Wise,W 111-74,200,39,66,0.591,33,55,0.600,6,11,0.545,27,36,0.750,111
283,2015-12-29,Charlotte,,Citadel,W 111-93,200,42,70,0.600,36,52,0.692,6,18,0.333,21,34,0.618,111
284,2016-01-23,Oakland,@,Green Bay,W 111-95,200,36,63,0.571,23,41,0.561,13,22,0.591,26,31,0.839,111
285,2016-02-06,Fresno State,,Nevada-Las Vegas,W 111-104 (2OT),250,40,89,0.449,29,59,0.492,11,30,0.367,20,25,0.800,111
286,2016-02-13,Oakland,,Green Bay,W 111-93,200,35,69,0.507,23,39,0.590,12,30,0.400,29,33,0.879,111
287,2016-02-27,Virginia Military Institute,,Citadel,W 111-95,200,40,72,0.556,29,45,0.644,11,27,0.407,20,26,0.769,111
288,2016-11-11,Georgia State,,Thomas University,W 111-69,200,35,68,0.515,26,48,0.542,9,20,0.450,32,41,0.780,111
289,2016-11-18,Kent State,,Hiram,W 111-55,200,38,79,0.481,27,52,0.519,11,27,0.407,24,32,0.750,111
290,2016-11-25,Kentucky,,Tennessee-Martin,W 111-76,200,41,74,0.554,34,52,0.654,7,22,0.318,22,29,0.759,111
291,2016-11-25,Ohio State,,Marshall,W 111-70,200,45,82,0.549,35,53,0.660,10,29,0.345,11,23,0.478,111
292,2016-12-10,Marshall,,Toledo,W 111-105 (OT),225,42,67,0.627,33,48,0.688,9,19,0.474,18,23,0.783,111
293,2016-12-19,Citadel,@,Maryland-Baltimore County,L 111-120 (2OT),250,39,104,0.375,20,54,0.370,19,50,0.380,14,18,0.778,111
294,2016-12-19,Morehead State,,Central Arkansas,W 111-85,200,39,73,0.534,21,38,0.553,18,35,0.514,15,20,0.750,111
295,2010-11-13,Duquesne,,Bluefield (WV),W 110-67,200,41,84,0.488,25,45,0.556,16,39,0.410,12,23,0.522,110
296,2010-11-19,Duke,,Colgate,W 110-58,200,34,72,0.472,22,42,0.524,12,30,0.400,30,39,0.769,110
297,2011-01-27,North Carolina-Greensboro,@,Chattanooga,L 110-111 (2OT),250,39,83,0.470,22,40,0.550,17,43,0.395,15,18,0.833,110
298,2011-01-31,Norfolk State,@,Coppin State,W 110-108 (2OT),250,37,75,0.493,27,53,0.509,10,22,0.455,26,44,0.591,110
299,2011-03-07,Oakland,N,South Dakota State,W 110-90,200,45,78,0.577,33,57,0.579,12,21,0.571,8,11,0.727,110
300,2011-12-04,Michigan State,,Nebraska-Omaha,W 110-68,200,46,75,0.613,38,59,0.644,8,16,0.500,10,11,0.909,110
301,2011-12-12,Longwood,,Virginia Military Institute,W 110-89,200,43,81,0.531,23,41,0.561,20,40,0.5,4,7,0.571,110
302,2011-12-30,Duke,,Western Michigan,W 110-70,200,34,63,0.54,20,36,0.556,14,27,0.519,28,35,0.8,110
303,2012-11-09,Weber State,,Arizona Christian,W 110-52,200,39,61,0.639,26,36,0.722,13,25,0.52,19,30,0.633,110
304,2012-11-11,Tulsa,,Louisiana State-Shreveport,W 110-54,200,36,69,0.522,23,43,0.535,13,26,0.5,25,30,0.833,110
305,2012-12-29,Weber State,,University of the Southwest,W 110-45,200,46,66,0.697,34,44,0.773,12,22,0.545,6,13,0.462,110
306,2013-01-02,Virginia Military Institute,,Shenandoah,W 110-54,200,44,77,0.571,30,42,0.714,14,35,0.4,8,11,0.727,110
307,2013-11-08,Georgia Southern,,Columbia International,W 110-74,200,38,67,0.567,31,45,0.689,7,22,0.318,27,43,0.628,110
308,2013-11-13,North Dakota,,Minnesota-Morris,W 110-69,200,43,75,0.573,33,55,0.6,10,20,0.5,14,22,0.636,110
309,2013-11-15,Boise State,,Simpson (CA),W 110-53,200,36,64,0.563,21,39,0.538,15,25,0.6,23,36,0.639,110
310,2013-11-17,UC-Irvine,,Pacifica,W 110-73,200,41,70,0.586,35,58,0.603,6,12,0.5,22,26,0.846,110
311,2013-11-25,Iowa State,,Missouri-Kansas City,W 110-51,200,36,70,0.514,24,38,0.632,12,32,0.375,26,39,0.667,110
312,2013-12-09,Virginia Military Institute,,Virginia-Lynchburg,W 110-78,200,41,91,0.451,30,44,0.682,11,47,0.234,17,26,0.654,110
313,2014-01-04,IPFW,,Kalamazoo,W 110-74,200,38,59,0.644,22,32,0.688,16,27,0.593,18,26,0.692,110
314,2014-01-23,Brigham Young,@,Portland,L 110-114 (3OT),275,36,80,0.45,27,56,0.482,9,24,0.375,29,43,0.674,110
315,2014-02-06,NJIT,,Wheelock,W 110-46,200,43,62,0.694,31,43,0.721,12,19,0.632,12,16,0.75,110
316,2014-03-05,Arkansas,,Mississippi,W 110-80,200,37,77,0.481,20,47,0.426,17,30,0.567,19,20,0.95,110
317,2014-11-14,Chattanooga,,Hiwassee,W 110-53,200,37,68,0.544,28,41,0.683,9,27,0.333,27,41,0.659,110
318,2014-11-22,North Carolina-Wilmington,@,Virginia Military Institute,W 110-93,200,47,79,0.595,45,72,0.625,2,7,0.286,14,20,0.7,110
319,2014-12-10,Davidson,@,Montana,W 110-99,200,33,56,0.589,23,33,0.697,10,23,0.435,34,36,0.944,110
320,2014-12-20,Incarnate Word,@,Missouri-Kansas City,W 110-104 (3OT),275,36,66,0.545,31,44,0.705,5,22,0.227,33,44,0.75,110
321,2015-02-03,Northwestern State,@,Central Arkansas,W 110-108,200,37,76,0.487,26,51,0.51,11,25,0.44,25,33,0.758,110
322,2015-02-21,Kentucky,,Auburn,W 110-75,200,44,68,0.647,38,51,0.745,6,17,0.353,16,23,0.696,110
323,2015-11-14,Tennessee Tech,,Piedmont,W 110-72,201,38,66,0.576,24,35,0.686,14,31,0.452,20,27,0.741,110
324,2015-11-16,Idaho State,,Dickinson State (ND),W 110-85,200,35,67,0.522,18,29,0.621,17,38,0.447,23,31,0.742,110
325,2015-11-16,North Texas,,Texas College,W 110-61,200,40,68,0.588,32,50,0.64,8,18,0.444,22,34,0.647,110
326,2015-11-18,Houston,,Prairie View,W 110-69,200,38,66,0.576,29,50,0.58,9,16,0.563,25,26,0.962,110
327,2015-11-22,Eastern Kentucky,,Longwood,W 110-97,200,40,60,0.667,27,36,0.75,13,24,0.542,17,25,0.68,110
328,2015-12-12,Houston Baptist,,Arlington Baptist,W 110-53,200,42,72,0.583,34,49,0.694,8,23,0.348,18,27,0.667,110
329,2016-01-15,Monmouth,@,Iona,W 110-102,200,36,62,0.581,23,40,0.575,13,22,0.591,25,32,0.781,110
330,2016-02-03,Illinois,@,Rutgers,W 110-101 (3OT),275,35,77,0.455,25,48,0.521,10,29,0.345,30,34,0.882,110
331,2016-02-16,Campbell,,Allen,W 110-66,200,38,51,0.745,27,30,0.9,11,21,0.524,23,28,0.821,110
332,2016-11-11,North Carolina-Wilmington,,Claflin,W 110-64,200,41,80,0.513,29,56,0.518,12,24,0.5,16,18,0.889,110
333,2016-11-16,Saint Mary's (CA),,Prairie View,W 110-72,200,39,68,0.574,25,36,0.694,14,32,0.438,18,21,0.857,110
334,2016-11-22,Nevada-Las Vegas,,Northern Arizona,W 110-71,200,45,83,0.542,34,54,0.63,11,29,0.379,9,16,0.563,110
335,2016-11-23,Citadel,@,Arizona State,L 110-127,200,42,84,0.5,29,47,0.617,13,37,0.351,13,16,0.813,110
336,2016-11-26,Grambling,N,Savannah State,W 110-104,200,40,73,0.548,27,42,0.643,13,31,0.419,17,28,0.607,110
337,2016-12-13,Portland State,,New Hope Christian,W 110-79,200,49,86,0.57,45,65,0.692,4,21,0.19,8,15,0.533,110
338,2016-12-15,North Florida,,Thomas University,W 110-80,200,34,56,0.607,21,30,0.7,13,26,0.5,29,40,0.725,110
339,2016-12-22,Wake Forest,,Louisiana State,W 110-76,200,41,69,0.594,25,43,0.581,16,26,0.615,12,18,0.667,110
340,2017-01-04,Duke,,Georgia Tech,W 110-57,200,39,70,0.557,23,39,0.59,16,31,0.516,16,19,0.842,110
341,2017-01-07,Marshall,,Charlotte,W 110-93,200,38,73,0.521,26,51,0.51,12,22,0.545,22,29,0.759,110
342,2017-01-14,Bryant,,Sacred Heart,L 110-112 (3OT),275,40,85,0.471,26,54,0.481,14,31,0.452,16,23,0.696,110
343,2017-02-01,Indiana,,Penn State,W 110-102 (3OT),275,41,78,0.526,35,57,0.614,6,21,0.286,22,32,0.688,110
344,2017-02-15,Butler,,St. John's (NY),W 110-86,200,34,59,0.576,21,33,0.636,13,26,0.5,29,40,0.725,110
345,2017-02-25,Savannah State,@,North Carolina A&T,W 110-91,200,37,86,0.43,17,33,0.515,20,53,0.377,16,24,0.667,110
346,2010-11-20,Brigham Young,,Chicago State,W 109-60,200,38,82,0.463,27,51,0.529,11,31,0.355,22,38,0.579,109
347,2010-11-20,Cal State Northridge,,Vanguard,W 109-66,200,40,67,0.597,36,54,0.667,4,13,0.308,25,29,0.862,109
348,2010-12-04,Western Michigan,,Alma,W 109-50,200,44,78,0.564,34,57,0.596,10,21,0.476,11,18,0.611,109
349,2010-12-30,South Dakota,,Doane College,W 109-92,200,37,65,0.569,26,39,0.667,11,26,0.423,24,34,0.706,109
350,2011-01-06,Coastal Carolina,@,Virginia Military Institute,W 109-87,200,40,72,0.556,37,62,0.597,3,10,0.3,26,38,0.684,109
351,2011-01-13,Tennessee Tech,,Tennessee-Martin,W 109-105 (3OT),275,41,79,0.519,37,69,0.536,4,10,0.4,23,35,0.657,109
352,2011-02-10,Washington,,University of California,W 109-77,200,43,76,0.566,26,45,0.578,17,31,0.548,6,7,0.857,109
353,2011-11-11,Weber State,,Northern New Mexico,W 109-50,200,37,61,0.607,20,32,0.625,17,29,0.586,18,23,0.783,109
354,2011-11-15,Western Carolina,,Montreat,W 109-63,200,38,74,0.514,28,44,0.636,10,30,0.333,23,34,0.676,109
355,2011-11-22,San Jose State,,Holy Names,W 109-71,200,41,71,0.577,30,46,0.652,11,25,0.44,16,22,0.727,109
356,2011-12-07,Montana State,,Willamette,W 109-64,200,38,71,0.535,28,50,0.56,10,21,0.476,23,34,0.676,109
357,2011-12-08,Virginia Military Institute,,Central Pennsylvania College,W 109-86,200,43,88,0.489,34,53,0.642,9,35,0.257,14,23,0.609,109
358,2011-12-11,Elon,,Lynchburg,W 109-67,200,40,73,0.548,27,46,0.587,13,27,0.481,16,21,0.762,109
359,2011-12-14,Rice,,Louisiana College,W 109-51,200,37,70,0.529,34,55,0.618,3,15,0.2,32,40,0.8,109
360,2011-12-15,North Carolina-Asheville,,Montreat,W 109-61,200,44,69,0.638,40,57,0.702,4,12,0.333,17,25,0.68,109
361,2012-11-12,North Carolina Central,,Johnson & Wales (NC),W 109-46,200,36,64,0.563,28,43,0.651,8,21,0.381,29,39,0.744,109
362,2012-12-08,Florida A&M,,Allen,W 109-59,200,44,79,0.557,38,66,0.576,6,13,0.462,15,26,0.577,109
363,2013-01-02,Virginia Commonwealth,@,East Tennessee State,W 109-58,200,40,73,0.548,24,39,0.615,16,34,0.471,13,22,0.591,109
364,2013-11-12,Central Arkansas,,Hendrix,W 109-59,200,39,79,0.494,28,55,0.509,11,24,0.458,20,32,0.625,109
365,2013-11-13,Purdue,,Central Connecticut State,W 109-73,200,43,79,0.544,34,55,0.618,9,24,0.375,14,24,0.583,109
366,2013-11-14,Iowa,,Maryland-Eastern Shore,W 109-63,200,35,68,0.515,28,51,0.549,7,17,0.412,32,43,0.744,109
367,2013-11-17,New Mexico,,Charleston Southern,W 109-93,200,34,57,0.596,25,39,0.641,9,18,0.5,32,43,0.744,109
368,2013-11-20,Mercer,,Johnson & Wales (NC),W 109-56,200,35,59,0.593,28,38,0.737,7,21,0.333,32,43,0.744,109
369,2013-11-21,North Florida,,Webber,W 109-64,200,38,62,0.613,23,32,0.719,15,30,0.5,18,22,0.818,109
370,2013-11-22,Southeast Missouri State,,Mid-Continent,W 109-64,199,42,80,0.525,36,56,0.643,6,24,0.25,19,31,0.613,109
371,2013-11-25,Citadel,,Montreat,W 109-64,199,36,63,0.571,22,33,0.667,14,30,0.467,23,26,0.885,109
372,2013-12-07,Montana State,,Walla Walla,W 109-54,200,44,70,0.629,34,52,0.654,10,18,0.556,11,16,0.688,109
373,2013-12-08,Colorado State,,Southwestern Oklahoma State,W 109-55,200,36,57,0.632,26,39,0.667,10,18,0.556,27,35,0.771,109
374,2013-12-19,Montana State,,Southwestern Christian,W 109-79,200,41,66,0.621,28,42,0.667,13,24,0.542,14,21,0.667,109
375,2014-01-28,Virginia Military Institute,@,North Carolina-Asheville,W 109-105,200,36,78,0.462,25,57,0.439,11,21,0.524,26,38,0.684,109
376,2014-02-06,Davidson,@,Samford,W 109-88,200,37,57,0.649,21,35,0.6,16,22,0.727,19,29,0.655,109
377,2014-11-14,Texas A&M,,Northwestern State,W 109-68,200,42,74,0.568,34,57,0.596,8,17,0.471,17,27,0.63,109
378,2014-11-15,Duke,,Fairfield,W 109-59,200,40,62,0.645,31,40,0.775,9,22,0.409,20,28,0.714,109
379,2014-11-20,Minnesota,,Franklin Pierce,W 109-57,200,42,72,0.583,31,57,0.544,11,15,0.733,14,24,0.583,109
380,2014-11-22,Gonzaga,,St. Thomas Aquinas,W 109-55,200,42,62,0.677,35,45,0.778,7,17,0.412,18,23,0.783,109
381,2014-12-01,Detroit Mercy,,Aquinas,W 109-59,200,41,68,0.603,29,46,0.63,12,22,0.545,15,26,0.577,109
382,2014-12-27,Weber State,,Bristol University,W 109-59,200,42,60,0.7,27,39,0.692,15,21,0.714,10,15,0.667,109
383,2015-01-13,Stephen F. Austin,@,Central Arkansas,W 109-58,200,39,67,0.582,31,50,0.62,8,17,0.471,23,30,0.767,109
384,2015-11-13,Buffalo,,Pittsburgh-Bradford,W 109-49,200,40,75,0.533,30,50,0.6,10,25,0.4,19,26,0.731,109
385,2015-11-13,Kansas,,Northern Colorado,W 109-72,200,34,61,0.557,19,35,0.543,15,26,0.577,26,34,0.765,109
386,2015-11-15,Florida State,,Nicholls State,W 109-62,200,40,61,0.656,30,41,0.732,10,20,0.5,19,28,0.679,109
387,2015-12-01,Davidson,@,Charlotte,W 109-74,200,36,62,0.581,21,33,0.636,15,29,0.517,22,29,0.759,109
388,2015-12-06,Sam Houston State,,Sul Ross State,W 109-61,198,41,81,0.506,29,47,0.617,12,34,0.353,15,23,0.652,109
389,2016-01-04,Kansas,,Oklahoma,W 109-106 (3OT),275,40,94,0.426,29,72,0.403,11,22,0.5,18,23,0.783,109
390,2016-01-25,Houston Baptist,,Hillsdale,W 109-84,200,41,65,0.631,29,44,0.659,12,21,0.571,15,20,0.75,109
391,2016-02-06,Marshall,@,Texas-San Antonio,W 109-91,200,36,65,0.554,18,31,0.581,18,34,0.529,19,30,0.633,109
392,2016-11-11,Purdue,,McNeese State,W 109-65,200,39,70,0.557,30,47,0.638,9,23,0.391,22,31,0.71,109
393,2016-11-12,San Jose State,,West Coast Baptist,W 109-70,200,36,64,0.563,24,35,0.686,12,29,0.414,25,36,0.694,109
394,2016-11-14,North Florida,,Edward Waters,W 109-73,200,35,68,0.515,29,38,0.763,6,30,0.2,33,45,0.733,109
395,2016-11-18,Gonzaga,,Bryant,W 109-70,200,34,61,0.557,27,42,0.643,7,19,0.368,34,45,0.756,109
396,2016-11-21,Wright State,,Ohio Dominican,W 109-54,200,32,57,0.561,19,31,0.613,13,26,0.5,32,40,0.8,109
397,2016-12-10,Lamar,,Austin College,W 109-58,200,37,68,0.544,28,45,0.622,9,23,0.391,26,42,0.619,109
398,2016-12-10,San Jose State,,Life Pacific,W 109-70,200,39,71,0.549,26,46,0.565,13,25,0.52,18,24,0.75,109
399,2016-12-12,IUPUI,,Urbana,W 109-67,200,37,58,0.638,20,29,0.69,17,29,0.586,18,22,0.818,109
400,2016-12-17,DePaul,,Chicago State,W 109-61,200,38,57,0.667,25,37,0.676,13,20,0.65,20,29,0.69,109
401,2017-02-05,Florida State,,Clemson,W 109-61,200,41,62,0.661,24,32,0.75,17,30,0.567,10,12,0.833,109
402,2017-02-18,Ball State,@,Central Michigan,W 109-100 (OT),225,38,73,0.521,26,42,0.619,12,31,0.387,21,29,0.724,109
403,2017-02-21,Wichita State,,Evansville,W 109-83,200,35,65,0.538,22,42,0.524,13,23,0.565,26,33,0.788,109
404,2017-02-28,Eastern Michigan,@,Central Michigan,W 109-81,200,38,74,0.514,22,38,0.579,16,36,0.444,17,24,0.708,109
405,2017-03-07,Southern Utah,N,Montana State,W 109-105 (3OT),275,33,77,0.429,21,48,0.438,12,29,0.414,31,42,0.738,109
406,2010-11-15,Columbia,,Maryland-Eastern Shore,W 108-74,200,38,60,0.633,26,40,0.65,12,20,0.6,20,27,0.741,108
407,2010-11-17,Arkansas-Little Rock,,St. Gregory's,W 108-58,200,45,76,0.592,40,60,0.667,5,16,0.313,13,21,0.619,108
408,2010-12-04,Washington,,Texas Tech,W 108-79,200,41,73,0.562,32,56,0.571,9,17,0.529,17,23,0.739,108
409,2010-12-29,Duke,@,North Carolina-Greensboro,W 108-62,200,39,64,0.609,28,40,0.7,11,24,0.458,19,25,0.76,108
410,2010-12-30,Davidson,,Saint Joseph's (ME),W 108-39,200,41,69,0.594,29,42,0.69,12,27,0.444,14,16,0.875,108
411,2011-01-29,UC-Davis,,UC-Irvine,W 108-107 (2OT),250,37,77,0.481,24,49,0.49,13,28,0.464,21,32,0.656,108
412,2011-01-31,Coppin State,,Norfolk State,L 108-110 (2OT),250,39,89,0.438,31,61,0.508,8,28,0.286,22,32,0.688,108
413,2011-11-11,Kentucky,,Marist,W 108-58,200,46,75,0.613,42,65,0.646,4,10,0.4,12,15,0.8,108
414,2011-11-23,North Carolina A&T,,Johnson & Wales (NC),W 108-55,200,43,81,0.531,36,57,0.632,7,24,0.292,15,21,0.714,108
415,2011-11-30,Boise State,,Drake,W 108-64,200,36,59,0.61,22,37,0.595,14,22,0.636,22,34,0.647,108
416,2011-12-19,Arkansas State,,Lyon,W 108-61,200,40,72,0.556,36,53,0.679,4,19,0.211,24,37,0.649,108
417,2012-03-18,Oregon,,Iowa,W 108-97,200,35,59,0.593,25,36,0.694,10,23,0.435,28,32,0.875,108
418,2012-11-09,Loyola Marymount,,Pacifica,W 108-49,200,45,78,0.577,38,62,0.613,7,16,0.438,11,21,0.524,108
419,2012-11-13,Central Arkansas,,Hendrix,W 108-65,200,43,78,0.551,31,56,0.554,12,22,0.545,10,23,0.435,108
420,2012-11-28,Austin Peay,,Berea,W 108-53,200,38,67,0.567,26,41,0.634,12,26,0.462,20,27,0.741,108
421,2012-12-08,Syracuse,,Monmouth,W 108-56,200,42,82,0.512,31,52,0.596,11,30,0.367,13,27,0.481,108
422,2012-12-21,Chattanooga,,Reinhardt,W 108-78,200,42,74,0.568,39,61,0.639,3,13,0.231,21,30,0.7,108
423,2013-01-30,NJIT,,Fisher College,W 108-69,200,38,66,0.576,23,41,0.561,15,25,0.6,17,22,0.773,108
424,2013-02-25,Kansas,@,Iowa State,W 108-96 (OT),225,37,68,0.544,24,43,0.558,13,25,0.52,21,27,0.778,108
425,2013-02-28,Southeast Missouri State,@,Austin Peay,W 108-81,200,40,60,0.667,20,27,0.741,20,33,0.606,8,10,0.8,108
426,2013-11-12,George Washington,,Maine,W 108-81,200,38,70,0.543,27,42,0.643,11,28,0.393,21,28,0.75,108
427,2013-11-14,Sam Houston State,@,Prairie View,W 108-103 (2OT),250,33,63,0.524,25,47,0.532,8,16,0.5,34,46,0.739,108
428,2013-11-14,Southeastern Louisiana,,Champion Baptist,W 108-54,200,39,66,0.591,32,49,0.653,7,17,0.412,23,28,0.821,108
429,2013-11-15,Brigham Young,,Mount St. Mary's,W 108-76,200,41,68,0.603,33,50,0.66,8,18,0.444,18,30,0.6,108
430,2013-11-15,Mississippi Valley State,,Champion Baptist,W 108-48,201,44,75,0.587,33,49,0.673,11,26,0.423,9,17,0.529,108
431,2013-11-16,Chattanooga,,Montreat,W 108-51,200,39,70,0.557,29,47,0.617,10,23,0.435,20,34,0.588,108
432,2013-11-23,Youngstown State,,Westminster (PA),W 108-57,200,34,74,0.459,21,41,0.512,13,33,0.394,27,31,0.871,108
433,2013-11-29,Valparaiso,,Mercer,L 108-117 (3OT),275,35,74,0.473,26,45,0.578,9,29,0.31,29,32,0.906,108
434,2013-12-15,Tennessee State,,Fisk,W 108-85,200,38,74,0.514,35,61,0.574,3,13,0.231,29,37,0.784,108
435,2013-12-16,East Tennessee State,,Tusculum,W 108-87,200,35,65,0.538,23,36,0.639,12,29,0.414,26,30,0.867,108
436,2013-12-21,Delaware,N,Bryant,W 108-107 (OT),225,38,77,0.494,32,55,0.582,6,22,0.273,26,36,0.722,108
437,2014-02-05,Virginia Military Institute,@,Gardner-Webb,W 108-104 (4OT),300,43,89,0.483,31,62,0.5,12,27,0.444,10,19,0.526,108
438,2014-02-15,Abilene Christian,,Dallas Christian,W 108-69,201,39,67,0.582,25,38,0.658,14,29,0.483,16,17,0.941,108
439,2014-12-07,North Carolina,,East Carolina,W 108-64,200,45,75,0.6,44,68,0.647,1,7,0.143,17,22,0.773,108
440,2014-12-17,North Carolina Central,,Barber-Scotia,W 108-52,200,43,69,0.623,37,52,0.712,6,17,0.353,16,25,0.64,108
441,2014-12-27,Minnesota,,North Carolina-Wilmington,W 108-82,200,40,67,0.597,30,51,0.588,10,16,0.625,18,21,0.857,108
442,2015-01-15,Washington State,,Oregon,W 108-99 (OT),225,33,56,0.589,19,32,0.594,14,24,0.583,28,37,0.757,108
443,2015-01-17,Southeastern Louisiana,@,Incarnate Word,W 108-98 (2OT),250,37,63,0.587,25,41,0.61,12,22,0.545,22,31,0.71,108
444,2015-02-03,Central Arkansas,,Northwestern State,L 108-110,200,36,62,0.581,23,37,0.622,13,25,0.52,23,28,0.821,108
445,2015-11-13,Bethune-Cookman,,Trinity (FL),W 108-54,200,41,67,0.612,29,39,0.744,12,28,0.429,14,18,0.778,108
446,2015-11-13,Louisiana-Lafayette,,Louisiana College,W 108-68,200,41,69,0.594,37,44,0.841,4,25,0.16,22,32,0.688,108
447,2015-11-15,Richmond,,Stetson,W 108-85,200,42,77,0.545,27,46,0.587,15,31,0.484,9,14,0.643,108
448,2015-11-24,Colorado State,,Abilene Christian,W 108-100 (2OT),250,36,73,0.493,27,49,0.551,9,24,0.375,27,33,0.818,108
449,2015-11-25,Eastern Michigan,,Marygrove,W 108-64,200,39,73,0.534,35,59,0.593,4,14,0.286,26,40,0.65,108
450,2015-11-30,Nevada,,Holy Names,W 108-57,200,40,67,0.597,31,51,0.608,9,16,0.563,19,25,0.76,108
451,2015-12-02,North Florida,@,Louisiana State,L 108-119,200,39,76,0.513,20,43,0.465,19,33,0.576,11,13,0.846,108
452,2015-12-03,Incarnate Word,,Dallas Christian,W 108-71,200,41,78,0.526,33,53,0.623,8,25,0.32,18,23,0.783,108
453,2015-12-13,Nebraska-Omaha,@,Grand Canyon,W 108-104 (OT),225,34,61,0.557,25,39,0.641,9,22,0.409,31,40,0.775,108
454,2015-12-20,Green Bay,,Wisconsin-Superior,W 108-57,200,41,75,0.547,36,63,0.571,5,12,0.417,21,32,0.656,108
455,2015-12-22,Canisius,N,Louisiana-Monroe,W 108-96 (3OT),275,29,74,0.392,14,39,0.359,15,35,0.429,35,48,0.729,108
456,2016-01-25,Detroit Mercy,@,Green Bay,L 108-115 (OT),225,38,78,0.487,30,51,0.588,8,27,0.296,24,36,0.667,108
457,2016-02-04,Marshall,@,Texas-El Paso,L 108-112,200,38,71,0.535,27,43,0.628,11,28,0.393,21,25,0.84,108
458,2016-02-11,Massachusetts-Lowell,@,Maine,W 108-95 (OT),225,37,74,0.5,21,46,0.457,16,28,0.571,18,24,0.75,108
459,2016-02-14,Albany (NY),,Maine,W 108-64,200,41,71,0.577,34,50,0.68,7,21,0.333,19,24,0.792,108
460,2016-02-14,Massachusetts,@,Duquesne,W 108-99 (OT),225,32,70,0.457,18,39,0.462,14,31,0.452,30,43,0.698,108
461,2016-02-25,Texas-San Antonio,@,Charlotte,L 108-114 (2OT),250,37,74,0.5,23,43,0.535,14,31,0.452,20,29,0.69,108
462,2016-02-26,Oakland,,Detroit Mercy,W 108-97,200,38,64,0.594,27,39,0.692,11,25,0.44,21,28,0.75,108
463,2016-03-05,Marshall,,Southern Mississippi,W 108-106 (OT),225,37,74,0.5,29,43,0.674,8,31,0.258,26,33,0.788,108
464,2016-03-09,Nevada-Las Vegas,,Air Force,W 108-102 (3OT),275,31,66,0.47,19,30,0.633,12,36,0.333,34,44,0.773,108
465,2016-11-18,Southern Utah,,Bethesda University (CA),W 108-92,200,24,60,0.4,18,31,0.581,6,29,0.207,54,78,0.692,108
466,2016-11-22,South Carolina Upstate,@,Charlotte,W 108-103 (OT),225,41,77,0.532,31,54,0.574,10,23,0.435,16,20,0.8,108
467,2016-11-25,Princeton,,Rowan,W 108-46,200,42,76,0.553,29,45,0.644,13,31,0.419,11,16,0.688,108
468,2016-11-28,West Virginia,,Manhattan,W 108-61,200,35,74,0.473,27,56,0.482,8,18,0.444,30,43,0.698,108
469,2016-12-02,Citadel,,Colgate,W 108-101,200,31,62,0.5,15,27,0.556,16,35,0.457,30,34,0.882,108
470,2016-12-04,Tennessee-Martin,,Boyce,W 108-64,200,44,74,0.595,32,47,0.681,12,27,0.444,8,19,0.421,108
471,2016-12-05,North Carolina-Greensboro,,Mars Hill,W 108-56,200,37,59,0.627,19,32,0.594,18,27,0.667,16,21,0.762,108
472,2016-12-12,Southeastern Louisiana,,Florida A&M,W 108-69,200,40,69,0.58,26,41,0.634,14,28,0.5,14,17,0.824,108
473,2016-12-22,Green Bay,,Saint Mary's (MN),W 108-59,200,41,74,0.554,32,53,0.604,9,21,0.429,17,27,0.63,108
474,2017-01-23,Texas-Arlington,,Louisiana-Lafayette,W 108-71,200,40,70,0.571,27,39,0.692,13,31,0.419,15,21,0.714,108
475,2017-01-30,William & Mary,,Drexel,W 108-85,200,43,68,0.632,26,38,0.684,17,30,0.567,5,9,0.556,108
476,2017-02-01,Cal State Northridge,,Long Beach State,W 108-98,200,37,66,0.561,29,49,0.592,8,17,0.471,26,32,0.813,108
477,2017-02-04,North Carolina-Wilmington,,Delaware,W 108-80,200,36,52,0.692,15,20,0.75,21,32,0.656,15,20,0.75,108
478,2017-02-11,IPFW,,Nebraska-Omaha,W 108-101 (OT),225,39,79,0.494,23,37,0.622,16,42,0.381,14,22,0.636,108
479,2017-02-18,Maryland-Baltimore County,,Massachusetts-Lowell,W 108-102,200,34,59,0.576,18,33,0.545,16,26,0.615,24,30,0.8,108
480,2017-03-09,Villanova,N,St. John's (NY),W 108-67,200,36,57,0.632,21,28,0.75,15,29,0.517,21,25,0.84,108
481,2010-11-18,North Carolina,N,Hofstra,W 107-63,200,40,71,0.563,28,54,0.519,12,17,0.706,15,26,0.577,107
482,2010-12-18,Ohio,@,St. Bonaventure,L 107-112 (4OT),300,40,101,0.396,31,61,0.508,9,40,0.225,18,24,0.75,107
483,2010-12-21,Chattanooga,,Reinhardt,W 107-48,200,40,76,0.526,26,42,0.619,14,34,0.412,13,19,0.684,107
484,2011-01-11,IPFW,,Southern Illinois-Edwardsville,W 107-79,200,39,68,0.574,29,44,0.659,10,24,0.417,19,22,0.864,107
485,2011-01-20,Utah Valley,@,North Dakota,W 107-96 (4OT),300,31,73,0.425,21,51,0.412,10,22,0.455,35,44,0.795,107
486,2011-01-22,Lamar,,Central Arkansas,W 107-72,200,37,69,0.536,23,40,0.575,14,29,0.483,19,27,0.704,107
487,2011-01-29,UC-Irvine,@,UC-Davis,L 107-108 (2OT),250,41,75,0.547,37,60,0.617,4,15,0.267,21,35,0.6,107
488,2011-02-05,Arizona,@,University of California,W 107-105 (3OT),275,35,74,0.473,21,40,0.525,14,34,0.412,23,31,0.742,107
489,2011-03-05,Syracuse,,DePaul,W 107-59,200,45,63,0.714,38,54,0.704,7,9,0.778,10,11,0.909,107
490,2011-11-23,Ohio State,,Virginia Military Institute,W 107-74,200,46,68,0.676,41,58,0.707,5,10,0.5,10,17,0.588,107
491,2011-11-25,Florida,,Jacksonville,W 107-62,200,37,67,0.552,26,42,0.619,11,25,0.44,22,35,0.629,107
492,2011-11-26,Central Arkansas,,Eastern Illinois,W 107-96 (2OT),250,40,74,0.541,39,68,0.574,1,6,0.167,26,46,0.565,107
493,2011-11-26,Winthrop,,Central Pennsylvania College,W 107-68,200,46,74,0.622,40,60,0.667,6,14,0.429,9,22,0.409,107
494,2011-12-03,Eastern Kentucky,,Brescia,W 107-43,200,37,60,0.617,21,35,0.6,16,25,0.64,17,28,0.607,107
495,2011-12-19,Indiana,,Howard,W 107-50,200,35,52,0.673,24,32,0.75,11,20,0.55,26,37,0.703,107
496,2012-01-03,Toledo,,Indiana-Northwest,W 107-43,200,39,71,0.549,31,52,0.596,8,19,0.421,21,25,0.84,107
497,2012-11-10,Tennessee Tech,,Crowley's Ridge,W 107-32,200,40,65,0.615,28,39,0.718,12,26,0.462,15,19,0.789,107
498,2012-12-07,Prairie View,,Dallas Christian,W 107-59,200,41,74,0.554,35,60,0.583,6,14,0.429,19,29,0.655,107
499,2012-12-31,Central Arkansas,,Central Baptist,W 107-82,200,41,76,0.539,31,52,0.596,10,24,0.417,15,22,0.682,107
500,2013-01-10,Belmont,,Southeast Missouri State,W 107-72,200,40,65,0.615,29,42,0.69,11,23,0.478,16,27,0.593,107
501,2013-01-19,Baylor,,Hardin-Simmons,W 107-38,200,40,74,0.541,30,53,0.566,10,21,0.476,17,30,0.567,107
502,2013-11-08,Creighton,,Alcorn State,W 107-61,200,35,63,0.556,24,39,0.615,11,24,0.458,26,36,0.722,107
503,2013-11-09,Delaware State,,Cairn,W 107-48,200,41,70,0.586,31,46,0.674,10,24,0.417,15,25,0.6,107
504,2013-11-09,Morehead State,,Mid-Continent,W 107-60,200,43,86,0.5,37,57,0.649,6,29,0.207,15,24,0.625,107
505,2013-11-13,Oregon,,Western Carolina,W 107-83,200,32,49,0.653,24,35,0.686,8,14,0.571,35,47,0.745,107
506,2013-11-30,Northwestern State,,Niagara,W 107-100,200,39,66,0.591,33,46,0.717,6,20,0.3,23,35,0.657,107
507,2013-12-07,Michigan,,Houston Baptist,W 107-53,200,36,56,0.643,20,30,0.667,16,26,0.615,19,25,0.76,107
508,2013-12-14,Southern,,Dillard,W 107-64,200,39,76,0.513,31,51,0.608,8,25,0.32,21,29,0.724,107
509,2013-12-17,Weber State,,St. Katherine,W 107-36,200,38,67,0.567,30,41,0.732,8,26,0.308,23,30,0.767,107
510,2013-12-21,Bryant,N,Delaware,L 107-108 (OT),225,37,65,0.569,26,47,0.553,11,18,0.611,22,37,0.595,107
511,2014-01-02,Sam Houston State,@,Northwestern State,W 107-104 (2OT),250,33,77,0.429,24,45,0.533,9,32,0.281,32,52,0.615,107
512,2014-01-05,UCLA,,Southern California,W 107-73,200,41,71,0.577,30,48,0.625,11,23,0.478,14,18,0.778,107
513,2014-01-09,Belmont,@,Southeast Missouri State,W 107-94,201,38,60,0.633,21,34,0.618,17,26,0.654,14,19,0.737,107
514,2014-01-31,Virginia Military Institute,,Presbyterian,W 107-93,200,41,82,0.5,26,50,0.52,15,32,0.469,10,16,0.625,107
515,2014-02-25,Houston Baptist,,Arlington Baptist,W 107-55,200,41,73,0.562,28,49,0.571,13,24,0.542,12,16,0.75,107
516,2014-02-26,Winthrop,,North Carolina-Asheville,W 107-100 (OT),225,33,66,0.5,18,39,0.462,15,27,0.556,26,36,0.722,107
517,2014-11-14,Oregon,,Coppin State,W 107-65,200,41,73,0.562,27,50,0.54,14,23,0.609,11,17,0.647,107
518,2014-11-20,South Carolina Upstate,,Bob Jones University,W 107-41,200,36,61,0.59,21,34,0.618,15,27,0.556,20,30,0.667,107
519,2014-11-20,UCLA,,Nicholls State,W 107-74,200,38,68,0.559,27,47,0.574,11,21,0.524,20,29,0.69,107
520,2014-11-21,Illinois,,Austin Peay,W 107-66,200,40,67,0.597,26,42,0.619,14,25,0.56,13,18,0.722,107
521,2014-12-14,Northern Kentucky,,Cincinnati-Clermont,W 107-53,200,38,69,0.551,22,38,0.579,16,31,0.516,15,24,0.625,107
522,2015-01-10,Cornell,,Alfred,W 107-29,200,36,73,0.493,22,45,0.489,14,28,0.5,21,27,0.778,107
523,2015-03-07,Davidson,@,Duquesne,W 107-78,200,40,65,0.615,20,29,0.69,20,36,0.556,7,12,0.583,107
524,2015-11-13,Bucknell,,Shenandoah,W 107-61,200,42,62,0.677,30,40,0.75,12,22,0.545,11,17,0.647,107
525,2015-11-13,Columbia,,Kean,W 107-62,200,39,80,0.488,23,34,0.676,16,46,0.348,13,28,0.464,107
526,2015-11-13,Eastern Kentucky,,Coppin State,W 107-80,200,40,75,0.533,31,46,0.674,9,29,0.31,18,26,0.692,107
527,2015-11-13,West Virginia,,Northern Kentucky,W 107-61,200,33,68,0.485,27,43,0.628,6,25,0.24,35,46,0.761,107
528,2015-11-14,East Tennessee State,,Averett,W 107-59,200,35,65,0.538,30,43,0.698,5,22,0.227,32,39,0.821,107
529,2015-11-15,Purdue,,Vermont,W 107-79,200,36,65,0.554,18,29,0.621,18,36,0.5,17,27,0.63,107
530,2015-11-16,Nevada-Las Vegas,,New Mexico Highlands,W 107-45,200,40,74,0.541,27,47,0.574,13,27,0.481,14,23,0.609,107
531,2015-11-19,Georgia Tech,,Green Bay,W 107-77,200,42,75,0.56,31,51,0.608,11,24,0.458,12,18,0.667,107
532,2015-12-02,Virginia Military Institute,,Central Pennsylvania College,W 107-72,200,35,66,0.53,21,36,0.583,14,30,0.467,23,24,0.958,107
533,2015-12-06,James Madison,,Marshall,W 107-84,200,34,68,0.5,20,39,0.513,14,29,0.483,25,34,0.735,107
534,2015-12-14,Charleston Southern,,Columbia International,W 107-74,200,40,80,0.5,31,57,0.544,9,23,0.391,18,23,0.783,107
535,2015-12-18,Gardner-Webb,,Warren Wilson,W 107-62,200,39,71,0.549,28,45,0.622,11,26,0.423,18,30,0.6,107
536,2015-12-29,North Carolina Central,,Montreat,W 107-68,200,39,66,0.591,30,51,0.588,9,15,0.6,20,27,0.741,107
537,2015-12-31,San Francisco,,Portland,W 107-95,200,35,60,0.583,24,37,0.649,11,23,0.478,26,40,0.65,107
538,2016-01-18,Purdue,@,Rutgers,W 107-57,200,39,80,0.488,28,51,0.549,11,29,0.379,18,24,0.75,107
539,2016-02-04,Oakland,@,Youngstown State,W 107-85,200,39,73,0.534,29,47,0.617,10,26,0.385,19,23,0.826,107
540,2016-02-15,Central Arkansas,,Northwestern State,W 107-94,200,38,69,0.551,30,51,0.588,8,18,0.444,23,36,0.639,107
541,2016-02-18,North Florida,,NJIT,W 107-71,200,39,57,0.684,22,28,0.786,17,29,0.586,12,20,0.6,107
542,2016-02-20,Green Bay,,Youngstown State,W 107-90,200,43,81,0.531,30,50,0.6,13,31,0.419,8,12,0.667,107
543,2016-02-20,Portland State,,Eastern Washington,W 107-91,200,44,68,0.647,39,56,0.696,5,12,0.417,14,20,0.7,107
544,2016-03-15,Washington,,Long Beach State,W 107-102,200,36,72,0.5,31,55,0.564,5,17,0.294,30,38,0.789,107
545,2016-11-14,Austin Peay,,Oakland City,W 107-67,200,39,63,0.619,28,37,0.757,11,26,0.423,18,30,0.6,107
546,2016-11-14,East Tennessee State,,Detroit Mercy,W 107-78,200,41,60,0.683,33,39,0.846,8,21,0.381,17,25,0.68,107
547,2016-11-14,Rhode Island,,Marist,W 107-65,200,35,62,0.565,23,41,0.561,12,21,0.571,25,31,0.806,107
548,2016-11-14,West Virginia,,Mississippi Valley State,W 107-66,200,41,83,0.494,32,58,0.552,9,25,0.36,16,22,0.727,107
549,2016-11-17,Central Michigan,,Marygrove,W 107-58,200,40,89,0.449,30,48,0.625,10,41,0.244,17,23,0.739,107
550,2016-11-19,Oakland,,Chicago State,W 107-79,200,35,71,0.493,25,40,0.625,10,31,0.323,27,32,0.844,107
551,2016-11-22,North Carolina,N,Oklahoma State,W 107-75,200,37,64,0.578,29,47,0.617,8,17,0.471,25,29,0.862,107
552,2016-11-28,IPFW,,Siena Heights,W 107-59,200,40,65,0.615,30,43,0.698,10,22,0.455,17,25,0.68,107
553,2016-12-01,Presbyterian,,Johnson & Wales (NC),W 107-63,200,33,59,0.559,22,38,0.579,11,21,0.524,30,38,0.789,107
554,2016-12-04,Notre Dame,,North Carolina A&T,W 107-53,200,37,66,0.561,18,31,0.581,19,35,0.543,14,14,1,107
555,2016-12-06,Central Michigan,,Green Bay,W 107-97,200,36,79,0.456,21,41,0.512,15,38,0.395,20,23,0.87,107
556,2016-12-10,Weber State,,West Coast Baptist,W 107-51,200,36,73,0.493,23,51,0.451,13,22,0.591,22,25,0.88,107
557,2016-12-14,Chattanooga,,Tennessee Wesleyan,W 107-65,200,39,63,0.619,25,36,0.694,14,27,0.519,15,22,0.682,107
558,2016-12-18,Baylor,,John Brown,W 107-53,200,39,66,0.591,28,45,0.622,11,21,0.524,18,21,0.857,107
559,2016-12-22,Florida Gulf Coast,,Florida National University,W 107-50,200,44,66,0.667,37,55,0.673,7,11,0.636,12,17,0.706,107
560,2017-01-08,North Carolina,,North Carolina State,W 107-56,200,39,79,0.494,27,52,0.519,12,27,0.444,17,25,0.68,107
561,2017-01-14,Long Beach State,@,Hawaii,L 107-114 (OT),225,36,67,0.537,26,43,0.605,10,24,0.417,25,28,0.893,107
562,2017-02-02,Central Arkansas,,Northwestern State,W 107-97,200,36,64,0.563,25,39,0.641,11,25,0.44,24,35,0.686,107
563,2017-02-04,UCLA,@,Washington,W 107-66,200,43,71,0.606,32,47,0.681,11,24,0.458,10,12,0.833,107
564,2017-02-11,Quinnipiac,@,Rider,L 107-112,200,38,78,0.487,22,40,0.55,16,38,0.421,15,22,0.682,107
565,2017-02-18,New Mexico State,@,Texas-Rio Grande Valley,W 107-101,200,33,60,0.55,23,42,0.548,10,18,0.556,31,40,0.775,107
566,2017-03-04,New Mexico State,,Texas-Rio Grande Valley,W 107-81,200,34,65,0.523,26,41,0.634,8,24,0.333,31,39,0.795,107
567,2010-11-12,Virginia Military Institute,,Randolph,W 106-65,200,42,86,0.488,31,45,0.689,11,41,0.268,11,17,0.647,106
568,2010-11-22,Louisville,,Chattanooga,W 106-65,200,37,75,0.493,22,38,0.579,15,37,0.405,17,19,0.895,106
569,2010-11-22,Washington,N,Virginia,W 106-63,200,40,69,0.58,23,43,0.535,17,26,0.654,9,13,0.692,106
570,2010-12-11,Charleston Southern,,Milligan,W 106-61,200,37,67,0.552,31,53,0.585,6,14,0.429,26,32,0.813,106
571,2010-12-30,Tennessee Tech,,Crowley's Ridge,W 106-44,200,43,70,0.614,35,51,0.686,8,19,0.421,12,24,0.5,106
572,2011-02-01,North Carolina,@,Boston College,W 106-74,200,39,68,0.574,28,47,0.596,11,21,0.524,17,20,0.85,106
573,2011-02-09,Maryland,,Longwood,W 106-52,200,39,72,0.542,29,44,0.659,10,28,0.357,18,26,0.692,106
574,2011-11-11,Villanova,,Monmouth,W 106-70,200,36,66,0.545,24,41,0.585,12,25,0.48,22,26,0.846,106
575,2011-12-10,Mississippi State,,Troy,W 106-68,200,40,71,0.563,24,40,0.6,16,31,0.516,10,13,0.769,106
576,2011-12-13,Alcorn State,,Atlanta Christian,W 106-101 (2OT),250,36,75,0.48,26,55,0.473,10,20,0.5,24,33,0.727,106
577,2011-12-19,Notre Dame,,Sacred Heart,W 106-65,200,35,57,0.614,26,40,0.65,9,17,0.529,27,34,0.794,106
578,2011-12-19,Weber State,,Mayville State,W 106-57,200,37,62,0.597,19,29,0.655,18,33,0.545,14,16,0.875,106
579,2012-01-14,Baylor,,Oklahoma State,W 106-65,200,36,68,0.529,21,40,0.525,15,28,0.536,19,23,0.826,106
580,2012-01-14,Long Island University,,Monmouth,W 106-86,200,39,61,0.639,36,47,0.766,3,14,0.214,25,30,0.833,106
581,2012-02-13,Belmont,@,Stetson,W 106-93,200,37,64,0.578,25,44,0.568,12,20,0.6,20,21,0.952,106
582,2012-02-25,Monmouth,,Long Island University,W 106-78,200,41,72,0.569,30,48,0.625,11,24,0.458,13,20,0.65,106
583,2012-11-10,Santa Clara,,Simpson (CA),W 106-66,200,39,78,0.5,25,44,0.568,14,34,0.412,14,27,0.519,106
584,2012-11-19,Houston,,Louisiana College,W 106-59,200,39,77,0.506,32,61,0.525,7,16,0.438,21,39,0.538,106
585,2012-11-23,Cal State Fullerton,,San Diego Christian,W 106-60,200,41,72,0.569,28,40,0.7,13,32,0.406,11,19,0.579,106
586,2013-01-05,Boise State,,Walla Walla,W 106-39,200,39,62,0.629,27,36,0.75,12,26,0.462,16,22,0.727,106
587,2013-02-20,Murray State,@,Morehead State,W 106-100 (2OT),250,32,64,0.5,22,37,0.595,10,27,0.37,32,46,0.696,106
588,2013-02-28,Central Arkansas,@,Lamar,W 106-99 (2OT),250,38,86,0.442,27,65,0.415,11,21,0.524,19,31,0.613,106
589,2013-11-10,Dartmouth,,Lyndon State,W 106-61,200,31,60,0.517,24,38,0.632,7,22,0.318,37,44,0.841,106
590,2013-11-11,Detroit Mercy,,Michigan-Dearborn,W 106-51,200,34,65,0.523,24,42,0.571,10,23,0.435,28,34,0.824,106
591,2013-11-13,Louisiana Tech,,Centenary (LA),W 106-59,200,38,67,0.567,29,39,0.744,9,28,0.321,21,24,0.875,106
592,2013-11-19,Incarnate Word,,Northwood (TX),W 106-94,200,36,73,0.493,19,44,0.432,17,29,0.586,17,27,0.63,106
593,2013-11-20,IPFW,,Purdue Calumet,W 106-72,200,39,73,0.534,27,47,0.574,12,26,0.462,16,24,0.667,106
594,2013-11-24,UCLA,,Chattanooga,W 106-65,200,44,70,0.629,40,61,0.656,4,9,0.444,14,21,0.667,106
595,2013-12-14,Gardner-Webb,,Clearwater Christian,W 106-54,200,43,61,0.705,38,48,0.792,5,13,0.385,15,27,0.556,106
596,2013-12-17,Florida State,,Charlotte,W 106-62,200,39,72,0.542,30,50,0.6,9,22,0.409,19,25,0.76,106
597,2013-12-30,Western Carolina,,Milligan,W 106-72,200,35,72,0.486,22,41,0.537,13,31,0.419,23,27,0.852,106
598,2014-03-01,UC-Riverside,,Cal State Northridge,W 106-105 (2OT),250,34,72,0.472,30,55,0.545,4,17,0.235,34,39,0.872,106
599,2014-03-22,Virginia Military Institute,,IPFW,W 106-95,200,37,63,0.587,28,42,0.667,9,21,0.429,23,32,0.719,106
600,2014-11-14,Central Michigan,,Alma,W 106-64,200,35,65,0.538,22,39,0.564,13,26,0.5,23,37,0.622,106
601,2014-11-17,Louisiana-Monroe,,Champion Baptist,W 106-39,200,41,69,0.594,32,45,0.711,9,24,0.375,15,24,0.625,106
602,2014-11-20,Charlotte,N,Penn State,W 106-97 (2OT),250,32,65,0.492,23,46,0.5,9,19,0.474,33,46,0.717,106
603,2014-11-20,Virginia Commonwealth,,Maryland-Eastern Shore,W 106-66,200,39,70,0.557,24,37,0.649,15,33,0.455,13,21,0.619,106
604,2014-11-23,Ohio State,,Sacred Heart,W 106-48,200,41,72,0.569,31,49,0.633,10,23,0.435,14,18,0.778,106
605,2014-11-24,Texas Christian,,Mississippi Valley State,W 106-53,200,40,66,0.606,28,43,0.651,12,23,0.522,14,24,0.583,106
606,2014-12-14,Connecticut,,Coppin State,W 106-85,200,37,65,0.569,30,47,0.638,7,18,0.389,25,33,0.758,106
607,2014-12-16,Texas,,Lipscomb,W 106-61,200,35,65,0.538,23,41,0.561,12,24,0.5,24,37,0.649,106
608,2014-12-17,High Point,,Ferrum,W 106-48,200,39,55,0.709,32,45,0.711,7,10,0.7,21,27,0.778,106
609,2014-12-20,Longwood,,Penn State-Beaver,W 106-74,200,39,63,0.619,34,47,0.723,5,16,0.313,23,30,0.767,106
610,2015-01-06,North Florida,,Trinity Baptist,W 106-60,200,38,57,0.667,22,27,0.815,16,30,0.533,14,18,0.778,106
611,2015-11-13,Mississippi State,,Eastern Washington,W 106-88,200,41,66,0.621,36,49,0.735,5,17,0.294,19,24,0.792,106
612,2015-11-15,Cincinnati,,Robert Morris,W 106-44,200,38,71,0.535,27,47,0.574,11,24,0.458,19,26,0.731,106
613,2015-11-16,Iowa State,,Chicago State,W 106-64,200,41,69,0.594,33,44,0.75,8,25,0.32,16,27,0.593,106
614,2015-11-16,North Florida,,Texas-Rio Grande Valley,W 106-84,200,37,66,0.561,20,34,0.588,17,32,0.531,15,22,0.682,106
615,2015-11-17,Winthrop,,Truett-McConnell,W 106-78,200,33,67,0.493,21,39,0.538,12,28,0.429,28,39,0.718,106
616,2015-11-20,Howard,,Medgar Evers,W 106-64,200,35,63,0.556,27,43,0.628,8,20,0.4,28,36,0.778,106
617,2015-11-24,James Madison,,East Mennonite,W 106-74,200,38,58,0.655,23,34,0.676,15,24,0.625,15,20,0.75,106
618,2015-11-25,Louisiana-Lafayette,,Loyola (LA),W 106-62,200,36,68,0.529,25,42,0.595,11,26,0.423,23,32,0.719,106
619,2015-12-13,Elon,,Wesley,W 106-77,200,38,73,0.521,23,37,0.622,15,36,0.417,15,24,0.625,106
620,2015-12-28,North Carolina-Wilmington,,Campbell,W 106-83,200,39,70,0.557,30,52,0.577,9,18,0.5,19,26,0.731,106
621,2016-01-04,North Carolina,@,Florida State,W 106-90,200,38,76,0.5,32,59,0.542,6,17,0.353,24,32,0.75,106
622,2016-01-04,Oklahoma,@,Kansas,L 106-109 (3OT),275,36,88,0.409,20,55,0.364,16,33,0.485,18,24,0.75,106
623,2016-01-14,Eastern Washington,,Southern Utah,W 106-80,200,38,62,0.613,27,44,0.614,11,18,0.611,19,28,0.679,106
624,2016-01-16,IPFW,@,Nebraska-Omaha,W 106-101 (OT),225,39,75,0.52,22,44,0.5,17,31,0.548,11,12,0.917,106
625,2016-03-05,Southern Mississippi,@,Marshall,L 106-108 (OT),225,30,57,0.526,15,27,0.556,15,30,0.5,31,41,0.756,106
626,2016-11-11,Morehead State,,Kentucky Christian,W 106-41,200,41,73,0.562,30,51,0.588,11,22,0.5,13,20,0.65,106
627,2016-11-13,Cal State Fullerton,,Portland State,W 106-100 (2OT),250,36,73,0.493,24,42,0.571,12,31,0.387,22,26,0.846,106
628,2016-11-27,Nicholls State,@,Samford,W 106-103 (2OT),250,35,69,0.507,19,33,0.576,16,36,0.444,20,22,0.909,106
629,2016-12-06,Winthrop,,Greensboro,W 106-63,200,42,80,0.525,31,53,0.585,11,27,0.407,11,16,0.688,106
630,2016-12-21,Central Michigan,@,Montana State,W 106-103,200,31,62,0.5,16,26,0.615,15,36,0.417,29,37,0.784,106
631,2016-12-22,Georgia Southern,,Fisk,W 106-58,200,37,80,0.463,23,40,0.575,14,40,0.35,18,33,0.545,106
632,2016-12-22,Canisius,@,St. Bonaventure,W 106-101 (OT),225,37,71,0.521,22,33,0.667,15,38,0.395,17,18,0.944,106
633,2016-12-28,Marshall,@,Pittsburgh,L 106-112,200,35,71,0.493,25,41,0.61,10,30,0.333,26,30,0.867,106
634,2017-01-20,Wright State,,Detroit Mercy,W 106-88,200,31,63,0.492,20,36,0.556,11,27,0.407,33,45,0.733,106
635,2017-01-24,Louisville,@,Pittsburgh,W 106-51,200,39,67,0.582,27,45,0.6,12,22,0.545,16,23,0.696,106
636,2017-01-25,Florida,@,Louisiana State,W 106-71,200,36,64,0.563,17,31,0.548,19,33,0.576,15,23,0.652,106
637,2017-02-11,Central Arkansas,,Nicholls State,W 106-83,200,35,62,0.565,18,34,0.529,17,28,0.607,19,25,0.76,106
638,2017-02-16,Santa Clara,,Pepperdine,W 106-55,200,39,61,0.639,17,25,0.68,22,36,0.611,6,7,0.857,106
639,2017-02-20,Maryland-Eastern Shore,,North Carolina A&T,W 106-95 (3OT),275,28,62,0.452,21,38,0.553,7,24,0.292,43,53,0.811,106
640,2017-03-04,Marshall,,North Texas,W 106-104,200,36,74,0.486,25,47,0.532,11,27,0.407,23,30,0.767,106
641,2017-03-06,Central Michigan,@,Kent State,L 106-116 (OT),225,36,77,0.468,18,40,0.45,18,37,0.486,16,17,0.941,106
642,2010-11-08,Maryland,,Seattle,W 105-76,200,35,62,0.565,33,54,0.611,2,8,0.25,33,41,0.805,105
643,2010-11-18,Florida,,North Carolina A&T,W 105-55,200,42,73,0.575,33,51,0.647,9,22,0.409,12,17,0.706,105
644,2010-11-26,Oakland,N,Southern,W 105-53,200,35,76,0.461,25,48,0.521,10,28,0.357,25,29,0.862,105
645,2010-11-27,IPFW,,Judson,W 105-65,200,37,74,0.5,25,44,0.568,12,30,0.4,19,23,0.826,105
646,2011-01-01,South Dakota State,@,Southern Utah,W 105-95,200,32,59,0.542,22,39,0.564,10,20,0.5,31,46,0.674,105
647,2011-01-13,Virginia Military Institute,@,Radford,W 105-71,200,37,69,0.536,22,39,0.564,15,30,0.5,16,25,0.64,105
648,2011-01-13,Tennessee-Martin,@,Tennessee Tech,L 105-109 (3OT),275,37,82,0.451,31,59,0.525,6,23,0.261,25,39,0.641,105
649,2011-02-05,University of California,,Arizona,L 105-107 (3OT),275,34,69,0.493,27,57,0.474,7,12,0.583,30,42,0.714,105
650,2011-02-19,Oakland,,South Dakota State,W 105-96,200,38,70,0.543,28,43,0.651,10,27,0.37,19,22,0.864,105
651,2011-02-26,South Dakota,,Chicago State,W 105-73,200,35,71,0.493,20,38,0.526,15,33,0.455,20,29,0.69,105
652,2011-12-19,Iowa,,Central Arkansas,W 105-64,200,42,76,0.553,37,63,0.587,5,13,0.385,16,21,0.762,105
653,2012-02-02,Iona,,Canisius,W 105-86,200,40,71,0.563,27,46,0.587,13,25,0.52,12,21,0.571,105
654,2012-03-08,Marshall,N,Tulsa,W 105-100 (3OT),275,36,75,0.48,31,58,0.534,5,17,0.294,28,43,0.651,105
655,2012-03-25,Utah State,,Oakland,W 105-81,200,37,58,0.638,25,42,0.595,12,16,0.75,19,25,0.76,105
656,2012-11-10,Alabama-Birmingham,,Young Harris,W 105-59,200,37,69,0.536,26,48,0.542,11,21,0.524,20,24,0.833,105
657,2012-11-15,Charleston Southern,,Hiwassee,W 105-69,200,33,68,0.485,21,37,0.568,12,31,0.387,27,32,0.844,105
658,2012-11-20,Creighton,,Longwood,W 105-57,199,35,54,0.648,28,39,0.718,7,15,0.467,28,38,0.737,105
659,2012-12-29,Charleston Southern,,Virginia Intermont,W 105-59,200,37,73,0.507,22,45,0.489,15,28,0.536,16,21,0.762,105
660,2012-12-30,Boise State,,Corban,W 105-49,200,40,71,0.563,28,42,0.667,12,29,0.414,13,16,0.813,105
661,2013-01-05,Cal State Fullerton,@,Cal State Northridge,W 105-86,200,34,58,0.586,22,35,0.629,12,23,0.522,25,31,0.806,105
662,2013-01-31,Louisiana-Lafayette,,North Texas,W 105-74,200,38,71,0.535,27,49,0.551,11,22,0.5,18,23,0.783,105
663,2013-02-07,Marist,@,Iona,W 105-104 (2OT),250,37,84,0.44,26,58,0.448,11,26,0.423,20,29,0.69,105
664,2013-11-15,Indiana,,Samford,W 105-59,200,36,63,0.571,30,48,0.625,6,15,0.4,27,41,0.659,105
665,2013-11-16,Radford,,Brevard,W 105-57,200,40,62,0.645,30,40,0.75,10,22,0.455,15,23,0.652,105
666,2013-11-18,Virginia Tech,,Virginia Military Institute,W 105-92,200,36,69,0.522,25,52,0.481,11,17,0.647,22,26,0.846,105
667,2013-11-19,Kentucky,,Texas-Arlington,W 105-76,200,35,69,0.507,27,50,0.54,8,19,0.421,27,39,0.692,105
668,2013-11-26,Charleston Southern,,Trinity (FL),W 105-58,199,32,62,0.516,23,43,0.535,9,19,0.474,32,45,0.711,105
669,2013-11-26,Norfolk State,N,Stillman,W 105-83,200,41,66,0.621,38,60,0.633,3,6,0.5,20,26,0.769,105
670,2013-11-27,Louisiana-Lafayette,,Northwestern State,W 105-74,200,33,62,0.532,23,41,0.561,10,21,0.476,29,46,0.63,105
671,2013-11-28,UCLA,N,Nevada,W 105-84,200,34,56,0.607,24,36,0.667,10,20,0.5,27,29,0.931,105
672,2013-12-07,Massachusetts,N,Brigham Young,W 105-96,200,35,63,0.556,26,40,0.65,9,23,0.391,26,31,0.839,105
673,2013-12-07,Davidson,,Johnson & Wales (NC),W 105-63,200,37,63,0.587,31,44,0.705,6,19,0.316,25,38,0.658,105
674,2013-12-08,Mississippi,,Oregon,L 105-115 (OT),225,31,70,0.443,16,35,0.457,15,35,0.429,28,38,0.737,105
675,2014-01-06,Charleston Southern,,Columbia International,W 105-45,200,36,72,0.5,25,39,0.641,11,33,0.333,22,31,0.71,105
676,2014-01-28,North Carolina-Asheville,,Virginia Military Institute,L 105-109,200,34,74,0.459,25,55,0.455,9,19,0.474,28,36,0.778,105
677,2014-02-22,North Carolina,,Wake Forest,W 105-72,200,35,61,0.574,24,46,0.522,11,15,0.733,24,29,0.828,105
678,2014-03-01,Cal State Northridge,@,UC-Riverside,L 105-106 (2OT),250,34,72,0.472,28,59,0.475,6,13,0.462,31,36,0.861,105
679,2014-11-14,Alabama State,,Auburn Montgomery,W 105-64,200,38,73,0.521,28,50,0.56,10,23,0.435,19,27,0.704,105
680,2014-11-21,Auburn,,Louisiana-Lafayette,W 105-80,200,36,66,0.545,25,40,0.625,11,26,0.423,22,29,0.759,105
681,2014-11-23,Wichita State,,Newman,W 105-57,200,35,67,0.522,25,44,0.568,10,23,0.435,25,39,0.641,105
682,2014-11-24,Incarnate Word,,Texas A&M-International,W 105-83,200,33,53,0.623,18,28,0.643,15,25,0.6,24,31,0.774,105
683,2014-12-01,South Carolina Upstate,,Barber-Scotia,W 105-43,200,42,79,0.532,28,43,0.651,14,36,0.389,7,11,0.636,105
684,2014-12-03,North Carolina-Wilmington,,St. Andrews,W 105-47,200,45,64,0.703,35,46,0.761,10,18,0.556,5,14,0.357,105
685,2014-12-04,Charleston Southern,,Columbia International,W 105-55,200,36,67,0.537,24,41,0.585,12,26,0.462,21,32,0.656,105
686,2014-12-10,Hofstra,@,Coppin State,W 105-64,200,36,66,0.545,23,41,0.561,13,25,0.52,20,25,0.8,105
687,2015-01-14,Central Michigan,,Miami (OH),W 105-77,200,35,51,0.686,16,24,0.667,19,27,0.704,16,23,0.696,105
688,2015-01-26,Arkansas-Pine Bluff,,Prairie View,W 105-68,200,31,49,0.633,19,29,0.655,12,20,0.6,31,33,0.939,105
689,2015-02-01,Niagara,,Quinnipiac,W 105-100 (2OT),250,32,67,0.478,20,45,0.444,12,22,0.545,29,35,0.829,105
690,2015-03-07,Villanova,,St. John's (NY),W 105-68,200,37,66,0.561,26,34,0.765,11,32,0.344,20,26,0.769,105
691,2015-11-13,Murray State,,Harris-Stowe,W 105-55,200,38,66,0.576,32,49,0.653,6,17,0.353,23,31,0.742,105
692,2015-11-16,Portland State,,Pacific Lutheran,W 105-60,200,37,62,0.597,26,40,0.65,11,22,0.5,20,32,0.625,105
693,2015-11-18,Chicago State,,Indiana-Northwest,W 105-64,200,36,76,0.474,27,46,0.587,9,30,0.3,24,28,0.857,105
694,2015-11-19,Miami (FL),N,Mississippi State,W 105-79,200,34,60,0.567,25,43,0.581,9,17,0.529,28,38,0.737,105
695,2015-11-20,Alabama,,Louisiana-Lafayette,W 105-93,200,32,59,0.542,17,34,0.5,15,25,0.6,26,35,0.743,105
696,2015-11-25,Nebraska-Omaha,@,Northern Colorado,W 105-85,200,32,63,0.508,24,43,0.558,8,20,0.4,33,39,0.846,105
697,2015-12-01,Belmont,,Lipscomb,W 105-89,200,35,59,0.593,19,28,0.679,16,31,0.516,19,24,0.792,105
698,2015-12-03,Southern Utah,,La Verne,W 105-85,200,34,57,0.596,30,46,0.652,4,11,0.364,33,44,0.75,105
699,2015-12-12,Indiana,,McNeese State,W 105-60,200,40,78,0.513,27,50,0.54,13,28,0.464,12,16,0.75,105
700,2015-12-13,Houston,,Louisiana State,W 105-98 (OT),225,37,72,0.514,32,57,0.561,5,15,0.333,26,39,0.667,105
701,2015-12-17,Southern Methodist,,Hampton,W 105-72,200,39,70,0.557,29,46,0.63,10,24,0.417,17,19,0.895,105
702,2015-12-19,Michigan,,Youngstown State,W 105-46,200,40,65,0.615,28,35,0.8,12,30,0.4,13,18,0.722,105
703,2015-12-19,Northwestern State,,Missouri Valley,W 105-79,200,38,69,0.551,26,45,0.578,12,24,0.5,17,19,0.895,105
704,2015-12-21,Creighton,,North Texas,W 105-82,200,36,63,0.571,32,46,0.696,4,17,0.235,29,40,0.725,105
705,2015-12-22,Utah,,Delaware State,W 105-58,200,37,60,0.617,25,37,0.676,12,23,0.522,19,24,0.792,105
706,2015-12-28,Duke,,Elon,W 105-66,200,39,76,0.513,27,47,0.574,12,29,0.414,15,19,0.789,105
707,2015-12-30,Alabama State,,Fort Valley State,W 105-89,200,39,67,0.582,27,41,0.659,12,26,0.462,15,23,0.652,105
708,2015-12-30,North Dakota State,,Northland,W 105-47,200,44,74,0.595,38,57,0.667,6,17,0.353,11,19,0.579,105
709,2016-01-27,Maine,@,Hartford,W 105-100 (OT),225,39,88,0.443,29,55,0.527,10,33,0.303,17,30,0.567,105
710,2016-02-16,Morehead State,,St. Catharine,W 105-66,200,36,66,0.545,27,44,0.614,9,22,0.409,24,32,0.75,105
711,2016-02-20,Sam Houston State,,Central Arkansas,W 105-75,200,36,65,0.554,20,32,0.625,16,33,0.485,17,21,0.81,105
712,2016-03-17,Kansas,N,Austin Peay,W 105-79,200,39,70,0.557,33,54,0.611,6,16,0.375,21,27,0.778,105
713,2016-11-12,Georgetown,,South Carolina Upstate,W 105-60,200,36,54,0.667,27,37,0.73,9,17,0.529,24,32,0.75,105
714,2016-11-15,Air Force,,Johnson & Wales,W 105-62,200,38,71,0.535,28,43,0.651,10,28,0.357,19,25,0.76,105
715,2016-11-25,New Mexico,N,Cal State Northridge,W 105-89,200,37,57,0.649,33,50,0.66,4,7,0.571,27,33,0.818,105
716,2016-12-03,Houston,,Prairie View,W 105-61,200,37,67,0.552,26,49,0.531,11,18,0.611,20,34,0.588,105
717,2016-12-05,Grambling,,Tougaloo,W 105-90,200,41,78,0.526,32,55,0.582,9,23,0.391,14,22,0.636,105
718,2016-12-06,Kansas,,Missouri-Kansas City,W 105-62,200,39,69,0.565,24,42,0.571,15,27,0.556,12,22,0.545,105
719,2016-12-10,Toledo,@,Marshall,L 105-111 (OT),225,39,73,0.534,28,45,0.622,11,28,0.393,16,29,0.552,105
720,2016-12-15,Cal State Bakersfield,,Bethesda University (CA),W 105-78,200,37,68,0.544,25,40,0.625,12,28,0.429,19,30,0.633,105
721,2016-12-17,San Diego,,Bethesda University (CA),W 105-89,200,30,60,0.5,19,30,0.633,11,30,0.367,34,43,0.791,105
722,2016-12-19,Syracuse,,Eastern Michigan,W 105-57,200,37,63,0.587,22,35,0.629,15,28,0.536,16,25,0.64,105
723,2016-12-28,Davidson,,Hartford,W 105-75,200,34,60,0.567,22,36,0.611,12,24,0.5,25,35,0.714,105
724,2017-01-02,Arkansas-Pine Bluff,,Mississippi Valley State,W 105-91,200,37,58,0.638,26,40,0.65,11,18,0.611,20,29,0.69,105
725,2017-01-07,Nevada,@,New Mexico,W 105-104 (OT),225,36,75,0.48,21,43,0.488,15,32,0.469,18,27,0.667,105
726,2017-01-21,UC-Irvine,@,Cal State Northridge,W 105-73,200,37,69,0.536,25,48,0.521,12,21,0.571,19,23,0.826,105
727,2017-01-28,Central Michigan,@,Kent State,W 105-98 (OT),225,34,70,0.486,20,34,0.588,14,36,0.389,23,28,0.821,105
728,2017-01-28,Maryland-Baltimore County,,New Hampshire,W 105-103 (2OT),250,36,72,0.5,25,47,0.532,11,25,0.44,22,28,0.786,105
729,2017-02-04,Illinois-Chicago,@,Milwaukee,W 105-100 (OT),225,36,59,0.61,21,31,0.677,15,28,0.536,18,21,0.857,105
730,2017-02-23,Northeastern,@,Elon,W 105-104 (2OT),250,36,72,0.5,20,36,0.556,16,36,0.444,17,20,0.85,105
731,2017-03-05,North Carolina-Wilmington,N,William & Mary,W 105-94,200,33,56,0.589,22,35,0.629,11,21,0.524,28,33,0.848,105
732,2017-03-07,Montana State,N,Southern Utah,L 105-109 (3OT),275,32,82,0.39,14,33,0.424,18,49,0.367,23,31,0.742,105
733,2010-11-12,Memphis,,Centenary (LA),W 104-40,200,33,60,0.55,19,33,0.576,14,27,0.519,24,33,0.727,104
734,2010-11-18,Lipscomb,,Austin Peay,W 104-101 (OT),225,32,61,0.525,22,32,0.688,10,29,0.345,30,40,0.75,104
735,2010-11-18,Longwood,,Virginia Wise,W 104-70,200,36,80,0.45,23,52,0.442,13,28,0.464,19,29,0.655,104
736,2010-12-11,Seton Hall,@,Massachusetts,W 104-79,200,36,60,0.6,25,38,0.658,11,22,0.5,21,25,0.84,104
737,2010-12-19,Colorado,,Longwood,W 104-59,200,38,72,0.528,28,55,0.509,10,17,0.588,18,23,0.783,104
738,2010-12-21,Iowa State,,Chicago State,W 104-63,200,33,66,0.5,23,38,0.605,10,28,0.357,28,35,0.8,104
739,2010-12-27,Louisville,,Morgan State,W 104-74,200,37,63,0.587,20,40,0.5,17,23,0.739,13,17,0.765,104
740,2011-01-05,Tennessee,,Memphis,W 104-84,200,36,67,0.537,24,46,0.522,12,21,0.571,20,30,0.667,104
741,2011-01-11,Brigham Young,@,Utah,W 104-79,200,36,76,0.474,22,52,0.423,14,24,0.583,18,24,0.75,104
742,2011-01-25,Florida,@,Georgia,W 104-91 (2OT),250,35,76,0.461,27,56,0.482,8,20,0.4,26,36,0.722,104
743,2011-11-12,Coastal Carolina,,Methodist,W 104-61,200,38,67,0.567,33,55,0.6,5,12,0.417,23,34,0.676,104
744,2011-11-23,Delaware State,,Philadelphia Biblical,W 104-41,200,42,70,0.6,32,47,0.681,10,23,0.435,10,14,0.714,104
745,2011-11-23,Iona,,Saint Joseph's,W 104-99 (2OT),250,38,84,0.452,29,60,0.483,9,24,0.375,19,24,0.792,104
746,2011-11-25,Creighton,,Campbell,W 104-81,200,38,54,0.704,24,33,0.727,14,21,0.667,14,27,0.519,104
747,2011-11-26,South Carolina State,@,Kennesaw State,W 104-98 (2OT),250,42,83,0.506,36,59,0.61,6,24,0.25,14,15,0.933,104
748,2011-11-26,North Carolina Central,,Barber-Scotia,W 104-55,200,39,68,0.574,30,47,0.638,9,21,0.429,17,23,0.739,104
749,2011-11-28,Columbia,,Swarthmore,W 104-42,200,36,68,0.529,20,35,0.571,16,33,0.485,16,19,0.842,104
750,2011-12-08,Eastern Washington,,Linfield,W 104-54,200,42,81,0.519,27,45,0.6,15,36,0.417,5,6,0.833,104
751,2011-12-15,Missouri,,Kennesaw State,W 104-67,200,39,65,0.6,33,47,0.702,6,18,0.333,20,25,0.8,104
752,2012-01-12,San Francisco,,Portland,W 104-70,200,39,58,0.672,26,40,0.65,13,18,0.722,13,18,0.722,104
753,2012-01-16,Lipscomb,,Stetson,W 104-103 (OT),225,41,74,0.554,33,53,0.623,8,21,0.381,14,28,0.5,104
754,2012-11-09,Utah,,Willamette,W 104-47,200,37,59,0.627,29,41,0.707,8,18,0.444,22,32,0.688,104
755,2012-11-23,Kentucky,,Long Island University,W 104-75,200,42,62,0.677,35,49,0.714,7,13,0.538,13,21,0.619,104
756,2012-11-29,Gonzaga,,Lewis & Clark,W 104-57,200,43,67,0.642,32,47,0.681,11,20,0.55,7,15,0.467,104
757,2012-12-15,Hawaii,@,Chaminade,W 104-93,200,39,65,0.6,28,44,0.636,11,21,0.524,15,21,0.714,104
758,2012-12-28,Liberty,,Union (KY),W 104-67,200,35,65,0.538,26,45,0.578,9,20,0.45,25,32,0.781,104
759,2013-01-12,Yale,,Oberlin,W 104-39,200,38,55,0.691,25,34,0.735,13,21,0.619,15,19,0.789,104
760,2013-02-07,Iona,,Marist,L 104-105 (2OT),250,36,82,0.439,25,56,0.446,11,26,0.423,21,27,0.778,104
761,2013-02-09,Notre Dame,,Louisville,W 104-101 (5OT),325,32,77,0.416,25,52,0.481,7,25,0.28,33,49,0.673,104
762,2013-03-02,St. Bonaventure,,Charlotte,W 104-83,200,30,51,0.588,19,33,0.576,11,18,0.611,33,42,0.786,104
763,2013-11-12,Drake,,Iowa Wesleyan,W 104-49,200,39,61,0.639,32,42,0.762,7,19,0.368,19,27,0.704,104
764,2013-11-14,Youngstown State,,Warren Wilson,W 104-58,200,37,68,0.544,27,42,0.643,10,26,0.385,20,31,0.645,104
765,2013-11-16,Georgia Southern,,Toccoa Falls,W 104-50,200,39,69,0.565,22,34,0.647,17,35,0.486,9,15,0.6,104
766,2013-11-24,Stony Brook,@,Detroit Mercy,W 104-102 (3OT),235,36,80,0.45,27,54,0.5,9,26,0.346,23,29,0.793,104
767,2013-12-01,Baylor,,Hardin-Simmons,W 104-59,200,38,60,0.633,28,41,0.683,10,19,0.526,18,29,0.621,104
768,2013-12-07,St. John's (NY),,Fordham,W 104-58,200,39,59,0.661,30,44,0.682,9,15,0.6,17,23,0.739,104
769,2013-12-17,Central Florida,,Jacksonville,W 104-64,200,38,63,0.603,25,35,0.714,13,28,0.464,15,20,0.75,104
770,2013-12-28,Nebraska-Omaha,@,Central Arkansas,W 104-88,200,36,68,0.529,25,46,0.543,11,22,0.5,21,24,0.875,104
771,2013-12-28,Fresno State,,UC-Merced,W 104-43,200,39,67,0.582,32,44,0.727,7,23,0.304,19,28,0.679,104
772,2014-01-02,Northwestern State,,Sam Houston State,L 104-107 (2OT),250,33,72,0.458,29,58,0.5,4,14,0.286,34,45,0.756,104
773,2014-01-03,Mount St. Mary's,@,Norfolk State,W 104-84,200,35,51,0.686,17,26,0.654,18,25,0.72,16,23,0.696,104
774,2014-01-04,Arkansas,,Texas-San Antonio,W 104-71,201,40,80,0.5,32,53,0.604,8,27,0.296,16,23,0.696,104
775,2014-01-11,Columbia,,Central Pennsylvania College,W 104-78,200,38,73,0.521,20,29,0.69,18,44,0.409,10,12,0.833,104
776,2014-02-05,Gardner-Webb,,Virginia Military Institute,L 104-108 (4OT),300,36,99,0.364,29,76,0.382,7,23,0.304,25,30,0.833,104
777,2014-02-08,Southern,@,Grambling,W 104-54,200,43,72,0.597,34,53,0.642,9,19,0.474,9,13,0.692,104
778,2014-02-12,Evansville,,Illinois State,W 104-98 (OT),225,28,53,0.528,24,44,0.545,4,9,0.444,44,56,0.786,104
779,2014-02-24,Hampton,@,Maryland-Eastern Shore,W 104-89,200,33,66,0.5,27,51,0.529,6,15,0.4,32,43,0.744,104
780,2014-02-26,Florida A&M,,Edward Waters,W 104-69,200,42,77,0.545,29,51,0.569,13,26,0.5,7,9,0.778,104
781,2014-03-07,Central Florida,,Houston,W 104-83,200,36,66,0.545,25,36,0.694,11,30,0.367,21,27,0.778,104
782,2014-11-14,Creighton,,Central Arkansas,W 104-77,200,35,72,0.486,26,46,0.565,9,26,0.346,25,30,0.833,104
783,2014-11-14,Gonzaga,,Sacramento State,W 104-58,200,36,66,0.545,26,42,0.619,10,24,0.417,22,32,0.688,104
784,2014-11-14,Southern Illinois-Edwardsville,,Harris-Stowe,W 104-56,200,36,74,0.486,24,48,0.5,12,26,0.462,20,26,0.769,104
785,2014-11-17,Delaware State,,Baptist Bible (PA),W 104-63,200,39,75,0.52,29,48,0.604,10,27,0.37,16,21,0.762,104
786,2014-11-19,Notre Dame,,Coppin State,W 104-67,200,40,61,0.656,31,42,0.738,9,19,0.474,15,20,0.75,104
787,2014-11-28,Montana State,,Texas-Arlington,W 104-81,200,28,54,0.519,10,28,0.357,18,26,0.692,30,33,0.909,104
788,2014-11-30,Eastern Washington,,Eastern Oregon,W 104-87,200,36,64,0.563,30,51,0.588,6,13,0.462,26,29,0.897,104
789,2014-12-08,Chattanooga,,Montreat,W 104-50,200,42,76,0.553,32,57,0.561,10,19,0.526,10,16,0.625,104
790,2014-12-14,Sacred Heart,,Mitchell,W 104-68,200,41,68,0.603,36,51,0.706,5,17,0.294,17,24,0.708,104
791,2014-12-20,Missouri-Kansas City,,Incarnate Word,L 104-110 (3OT),276,32,74,0.432,22,49,0.449,10,25,0.4,30,42,0.714,104
792,2014-12-28,Southern Illinois-Edwardsville,,Robert Morris (IL),W 104-56,200,34,66,0.515,22,42,0.524,12,24,0.5,24,31,0.774,104
793,2014-12-29,Western Kentucky,,Alice Lloyd,W 104-62,200,36,81,0.444,21,42,0.5,15,39,0.385,17,23,0.739,104
794,2015-01-08,South Alabama,,Appalachian State,W 104-95,200,30,49,0.612,20,32,0.625,10,17,0.588,34,44,0.773,104
795,2015-03-05,Delaware State,@,Coppin State,W 104-92,200,34,62,0.548,25,41,0.61,9,21,0.429,27,37,0.73,104
796,2015-03-19,Tennessee-Martin,@,Northwestern State,W 104-79,200,40,72,0.556,24,44,0.545,16,28,0.571,8,9,0.889,104
797,2015-11-13,Texas A&M,,South Carolina Upstate,W 104-64,200,38,57,0.667,25,33,0.758,13,24,0.542,15,27,0.556,104
798,2015-11-15,Nebraska-Omaha,,Saint Mary's (MN),W 104-58,200,41,77,0.532,28,44,0.636,13,33,0.394,9,10,0.9,104
799,2015-11-16,Florida,,North Carolina A&T,W 104-54,200,37,69,0.536,22,40,0.55,15,29,0.517,15,23,0.652,104
800,2015-11-18,Coastal Carolina,,Grace Bible,W 104-67,200,40,76,0.526,29,45,0.644,11,31,0.355,13,21,0.619,104