YEAR,ROUND,SEED,TEAM,SCORE,OPP_SEED,OPPONENT,OPP_SCORE,SCORE_DIFF,RESULT
1985,First Round,15,Middle Tennessee State,57,2,North Carolina,76,-19,LOSS
1985,Sweet 16,12,Kentucky,70,1,St. John's,86,-16,LOSS
1985,Second Round,5,Southern Methodist,57,4,Loyola (Ill.),70,-13,LOSS
1985,Elite Eight,2,North Carolina,44,8,Villanova,56,-12,LOSS
1985,First Round,13,Iowa State,64,4,Ohio State,75,-11,LOSS
1985,First Round,14,Nevada,56,3,North Carolina State,65,-9,LOSS
1985,First Round,10,Arizona,41,7,Alabama,50,-9,LOSS
1985,First Round,11,Wichita State,59,6,Georgia,67,-8,LOSS
1985,Second Round,1,Michigan,55,8,Villanova,59,-4,LOSS
1985,Second Round,2,Virginia Commonwealth,59,7,Alabama,63,-4,LOSS
1985,First Round,9,Virginia Tech,57,8,Temple,60,-3,LOSS
1985,First Round,8,Southern California,55,9,Illinois State,58,-3,LOSS
1985,Second Round,9,Arkansas,65,1,St. John's,68,-3,LOSS
1985,Sweet 16,5,Maryland,43,8,Villanova,46,-3,LOSS
1985,Second Round,3,Kansas,64,11,Auburn,66,-2,LOSS
1985,First Round,10,Michigan State,68,7,Alabama-Birmingham,70,-2,LOSS
1985,First Round,9,Dayton,49,8,Villanova,51,-2,LOSS
1985,Second Round,7,Notre Dame,58,2,North Carolina,60,-2,LOSS
1985,Second Round,3,Duke,73,11,Boston College,74,-1,LOSS
1985,First Round,6,Purdue,58,11,Auburn,59,-1,LOSS
1985,First Round,13,Iona,58,4,Loyola (Ill.),59,-1,LOSS
1985,First Round,5,Maryland,69,12,Miami (Ohio),68,1,WIN
1985,National Championship,8,Villanova,66,1,Georgetown,64,2,WIN
1985,First Round,8,Villanova,51,9,Dayton,49,2,WIN
1985,Second Round,2,North Carolina,60,7,Notre Dame,58,2,WIN
1985,Sweet 16,8,Villanova,46,5,Maryland,43,3,WIN
1985,Second Round,12,Kentucky,64,4,UNLV,61,3,WIN
1985,Second Round,8,Villanova,59,1,Michigan,55,4,WIN
1985,First Round,1,Michigan,59,16,Fairleigh Dickinson,55,4,WIN
1985,Second Round,5,Maryland,64,13,Navy,59,5,WIN
1985,Sweet 16,2,North Carolina,62,11,Auburn,56,6,WIN
1985,Final Four,8,Villanova,52,2,Memphis,45,7,WIN
1985,First Round,12,Kentucky,66,5,Washington,58,8,WIN
1985,First Round,9,Arkansas,63,8,Iowa,54,9,WIN
1985,First Round,7,Notre Dame,79,10,Oregon State,70,9,WIN
1985,First Round,3,Kansas,49,14,Ohio,38,11,WIN
1985,Elite Eight,8,Villanova,56,2,North Carolina,44,12,WIN
1985,First Round,3,Duke,75,14,Pepperdine,62,13,WIN
1985,First Round,2,Virginia Commonwealth,81,15,Marshall,65,16,WIN
1985,First Round,5,Southern Methodist,85,12,Old Dominion,68,17,WIN
1985,First Round,2,North Carolina,76,15,Middle Tennessee State,57,19,WIN
1986,First Round,12,Xavier,80,5,Alabama,97,-17,LOSS
1986,Sweet 16,3,North Carolina,79,2,Louisville,94,-15,LOSS
1986,Sweet 16,5,Michigan State,86,1,Kansas,96,-10,LOSS
1986,First Round,9,Arizona,63,8,Auburn,73,-10,LOSS
1986,First Round,7,Virginia Tech,62,10,Villanova,71,-9,LOSS
1986,First Round,9,West Virginia,64,8,Old Dominion,72,-8,LOSS
1986,First Round,6,Purdue,87,11,LSU,94,-7,LOSS
1986,First Round,3,Notre Dame,83,14,Arkansas-Little Rock,90,-7,LOSS
1986,Second Round,5,Maryland,64,4,UNLV,70,-6,LOSS
1986,Second Round,10,Villanova,61,2,Georgia Tech,66,-5,LOSS
1986,First Round,5,Virginia,68,12,DePaul,72,-4,LOSS
1986,Final Four,1,Kansas,67,1,Duke,71,-4,LOSS
1986,Sweet 16,7,Iowa State,66,6,North Carolina State,70,-4,LOSS
1986,National Championship,1,Duke,69,2,Louisville,72,-3,LOSS
1986,Second Round,2,Michigan,69,7,Iowa State,72,-3,LOSS
1986,Elite Eight,1,Kentucky,57,11,LSU,59,-2,LOSS
1986,First Round,5,Michigan State,72,12,Washington,70,2,WIN
1986,First Round,7,Iowa State,81,10,Miami (Ohio),79,2,WIN
1986,Second Round,7,Iowa State,72,2,Michigan,69,3,WIN
1986,National Championship,2,Louisville,72,1,Duke,69,3,WIN
1986,Final Four,1,Duke,71,1,Kansas,67,4,WIN
1986,Sweet 16,1,Kentucky,68,5,Alabama,63,5,WIN
1986,First Round,5,Maryland,69,12,Pepperdine,64,5,WIN
1986,First Round,2,Michigan,70,15,Akron,64,6,WIN
1986,Sweet 16,1,Duke,74,12,DePaul,67,7,WIN
1986,First Round,1,Duke,85,16,Mississippi Valley State,78,7,WIN
1986,Second Round,1,Kentucky,71,8,Western Kentucky,64,7,WIN
1986,Elite Eight,1,Kansas,75,6,North Carolina State,67,8,WIN
1986,Elite Eight,2,Louisville,84,8,Auburn,76,8,WIN
1986,First Round,10,Villanova,71,7,Virginia Tech,62,9,WIN
1986,Sweet 16,1,Kansas,96,5,Michigan State,86,10,WIN
1986,Final Four,2,Louisville,88,11,LSU,77,11,WIN
1986,Second Round,5,Michigan State,80,4,Georgetown,68,12,WIN
1986,First Round,3,North Carolina,84,14,Utah,72,12,WIN
1986,Second Round,2,Louisville,82,7,Bradley,68,14,WIN
1986,Sweet 16,2,Louisville,94,3,North Carolina,79,15,WIN
1986,Second Round,3,North Carolina,77,6,Alabama-Birmingham,59,18,WIN
1986,First Round,2,Louisville,93,15,Drexel,73,20,WIN
1986,First Round,1,Kentucky,75,16,Davidson,55,20,WIN
1986,Elite Eight,1,Duke,71,7,Navy,50,21,WIN
1986,Second Round,1,Kansas,65,9,Temple,43,22,WIN
1986,First Round,1,Kansas,71,16,North Carolina A&T,46,25,WIN
1986,Second Round,1,Duke,89,8,Old Dominion,61,28,WIN
1987,Second Round,7,New Orleans,76,2,Alabama,101,-25,LOSS
1987,Second Round,7,New Orleans,76,2,Alabama,101,-25,LOSS
1987,First Round,16,Bucknell,53,1,Georgetown,75,-22,LOSS
1987,Second Round,3,Purdue,66,6,Florida,85,-19,LOSS
1987,Second Round,9,Kansas State,61,1,UNLV,80,-19,LOSS
1987,Final Four,6,Providence,63,2,Syracuse,77,-14,LOSS
1987,First Round,8,Kentucky,77,9,Ohio State,91,-14,LOSS
1987,Sweet 16,5,Kansas,57,1,Georgetown,70,-13,LOSS
1987,First Round,12,Middle Tennessee State,71,5,Notre Dame,84,-13,LOSS
1987,Second Round,9,Michigan,97,1,North Carolina,109,-12,LOSS
1987,Second Round,4,UCLA,68,12,Wyoming,78,-10,LOSS
1987,First Round,10,Arizona,91,7,UTEP,98,-7,LOSS
1987,Sweet 16,6,Florida,81,2,Syracuse,87,-6,LOSS
1987,Sweet 16,5,Duke,82,1,Indiana,88,-6,LOSS
1987,Sweet 16,5,Notre Dame,68,1,North Carolina,74,-6,LOSS
1987,Second Round,13,Xavier,60,5,Duke,65,-5,LOSS
1987,First Round,5,Virginia,60,12,Wyoming,64,-4,LOSS
1987,Elite Eight,1,North Carolina,75,2,Syracuse,79,-4,LOSS
1987,First Round,11,Wichita State,55,6,St. John's,57,-2,LOSS
1987,First Round,7,West Virginia,62,10,Western Kentucky,64,-2,LOSS
1987,Second Round,5,Notre Dame,58,4,TCU,57,1,WIN
1987,First Round,13,Xavier,70,4,Missouri,69,1,WIN
1987,Second Round,6,Providence,90,14,Austin Peay,87,3,WIN
1987,First Round,9,Kansas State,82,8,Georgia,79,3,WIN
1987,First Round,7,New Orleans,83,10,Brigham Young,79,4,WIN
1987,First Round,7,New Orleans,83,10,Brigham Young,79,4,WIN
1987,Second Round,5,Kansas,67,13,Missouri State,63,4,WIN
1987,Second Round,5,Duke,65,13,Xavier,60,5,WIN
1987,Sweet 16,1,North Carolina,74,5,Notre Dame,68,6,WIN
1987,First Round,5,Duke,58,12,Texas A&M,51,7,WIN
1987,First Round,3,Purdue,104,14,Northeastern,95,9,WIN
1987,First Round,5,Kansas,66,12,Houston,55,11,WIN
1987,First Round,6,Florida,82,11,North Carolina State,70,12,WIN
1987,Second Round,1,North Carolina,109,9,Michigan,97,12,WIN
1987,First Round,5,Notre Dame,84,12,Middle Tennessee State,71,13,WIN
1987,Elite Eight,6,Providence,88,1,Georgetown,73,15,WIN
1987,First Round,9,Michigan,97,8,Navy,82,15,WIN
1987,Second Round,6,Florida,85,3,Purdue,66,19,WIN
1987,First Round,4,UCLA,92,13,Central Michigan,73,19,WIN
1987,Sweet 16,6,Providence,103,2,Alabama,82,21,WIN
1987,First Round,6,Providence,90,11,Alabama-Birmingham,68,22,WIN
1987,First Round,1,North Carolina,113,16,Penn,82,31,WIN
1988,Second Round,8,Seton Hall,55,1,Arizona,84,-29,LOSS
1988,Second Round,6,Florida,85,3,Michigan,108,-23,LOSS
1988,First Round,12,Wichita State,62,5,DePaul,83,-21,LOSS
1988,Elite Eight,6,Villanova,59,1,Oklahoma,78,-19,LOSS
1988,Elite Eight,2,North Carolina,52,1,Arizona,70,-18,LOSS
1988,Second Round,7,Southern Methodist,79,2,Duke,94,-15,LOSS
1988,Elite Eight,4,Kansas State,58,6,Kansas,71,-13,LOSS
1988,Sweet 16,7,Vanderbilt,64,6,Kansas,77,-13,LOSS
1988,First Round,11,Xavier,72,6,Kansas,85,-13,LOSS
1988,First Round,12,Iowa State,78,5,Georgia Tech,90,-12,LOSS
1988,Sweet 16,5,Louisville,98,1,Oklahoma,108,-10,LOSS
1988,Sweet 16,3,Michigan,69,2,North Carolina,78,-9,LOSS
1988,Second Round,7,Maryland,81,2,Kentucky,90,-9,LOSS
1988,First Round,11,Arkansas,74,6,Villanova,82,-8,LOSS
1988,First Round,10,Notre Dame,75,7,Southern Methodist,83,-8,LOSS
1988,Final Four,1,Arizona,78,1,Oklahoma,86,-8,LOSS
1988,Final Four,2,Duke,59,6,Kansas,66,-7,LOSS
1988,Sweet 16,2,Kentucky,74,6,Villanova,80,-6,LOSS
1988,First Round,12,Florida State,98,5,Iowa,102,-4,LOSS
1988,Sweet 16,1,Purdue,70,4,Kansas State,73,-3,LOSS
1988,Sweet 16,11,Rhode Island,72,2,Duke,73,-1,LOSS
1988,Sweet 16,2,Duke,73,11,Rhode Island,72,1,WIN
1988,Second Round,6,Villanova,66,3,Illinois,63,3,WIN
1988,First Round,6,Florida,62,11,St. John's,59,3,WIN
1988,Second Round,6,Kansas,61,14,Murray St.,58,3,WIN
1988,Second Round,11,Rhode Island,97,3,Syracuse,94,3,WIN
1988,Sweet 16,4,Kansas State,73,1,Purdue,70,3,WIN
1988,First Round,7,Vanderbilt,80,10,Utah State,77,3,WIN
1988,National Championship,6,Kansas,83,1,Oklahoma,79,4,WIN
1988,First Round,3,Michigan,63,14,Boise State,58,5,WIN
1988,Sweet 16,6,Villanova,80,2,Kentucky,74,6,WIN
1988,Second Round,7,Vanderbilt,80,2,Pittsburgh,74,6,WIN
1988,Final Four,6,Kansas,66,2,Duke,59,7,WIN
1988,First Round,11,Rhode Island,87,6,Missouri,80,7,WIN
1988,First Round,6,Villanova,82,11,Arkansas,74,8,WIN
1988,First Round,7,Southern Methodist,83,10,Notre Dame,75,8,WIN
1988,Second Round,4,Kansas State,66,5,DePaul,58,8,WIN
1988,First Round,5,Louisville,70,12,Oregon State,61,9,WIN
1988,Sweet 16,2,North Carolina,78,3,Michigan,69,9,WIN
1988,Second Round,2,Kentucky,90,7,Maryland,81,9,WIN
1988,Elite Eight,2,Duke,63,1,Temple,53,10,WIN
1988,First Round,7,Maryland,92,10,UC Santa Barbara,82,10,WIN
1988,Elite Eight,6,Kansas,71,4,Kansas State,58,13,WIN
1988,Sweet 16,6,Kansas,77,7,Vanderbilt,64,13,WIN
1988,First Round,6,Kansas,85,11,Xavier,72,13,WIN
1988,First Round,4,Kansas State,66,13,La Salle,53,13,WIN
1988,Second Round,2,Duke,94,7,Southern Methodist,79,15,WIN
1988,First Round,1,Purdue,94,16,Fairleigh Dickinson,79,15,WIN
1988,First Round,2,Kentucky,99,15,Southern,84,15,WIN
1988,First Round,2,Duke,85,15,Boston University,69,16,WIN
1988,First Round,8,Seton Hall,80,9,UTEP,64,16,WIN
1988,First Round,2,North Carolina,83,15,North Texas,65,18,WIN
1988,Elite Eight,1,Arizona,70,2,North Carolina,52,18,WIN
1988,Sweet 16,1,Arizona,99,5,Iowa,79,20,WIN
1988,Second Round,5,Louisville,97,4,Brigham Young,76,21,WIN
1988,Second Round,3,Michigan,108,6,Florida,85,23,WIN
1988,Second Round,2,North Carolina,123,10,Loyola Marymount,97,26,WIN
1988,Second Round,1,Purdue,100,9,Memphis,73,27,WIN
1988,Second Round,1,Arizona,84,8,Seton Hall,55,29,WIN
1988,First Round,1,Arizona,90,16,Cornell,50,40,WIN
1989,Elite Eight,5,Virginia,65,3,Michigan,102,-37,LOSS
1989,First Round,15,Bucknell,81,2,Syracuse,104,-23,LOSS
1989,First Round,7,Florida,46,10,Colorado State,68,-22,LOSS
1989,Final Four,2,Duke,78,3,Seton Hall,95,-17,LOSS
1989,Sweet 16,11,Minnesota,70,2,Duke,87,-17,LOSS
1989,First Round,14,Creighton,69,3,Missouri,85,-16,LOSS
1989,Second Round,13,Middle Tennessee State,88,5,Virginia,104,-16,LOSS
1989,First Round,8,Vanderbilt,65,9,Notre Dame,81,-16,LOSS
1989,First Round,12,South Carolina,66,5,North Carolina State,81,-15,LOSS
1989,Sweet 16,4,Louisville,69,1,Illinois,83,-14,LOSS
1989,First Round,4,Florida State,83,13,Middle Tennessee State,97,-14,LOSS
1989,First Round,6,Kansas State,75,11,Minnesota,86,-11,LOSS
1989,First Round,10,Iowa State,74,7,UCLA,84,-10,LOSS
1989,Second Round,5,Arkansas,84,4,Louisville,93,-9,LOSS
1989,Second Round,7,UCLA,81,2,North Carolina,88,-7,LOSS
1989,Second Round,9,Notre Dame,74,1,Georgetown,81,-7,LOSS
1989,Second Round,7,West Virginia,63,2,Duke,70,-7,LOSS
1989,Sweet 16,2,North Carolina,87,3,Michigan,92,-5,LOSS
1989,First Round,14,Xavier,87,3,Michigan,92,-5,LOSS
1989,First Round,12,Providence,97,5,Virginia,100,-3,LOSS
1989,First Round,16,East Tennessee State,71,1,Oklahoma,72,-1,LOSS
1989,National Championship,3,Seton Hall,79,3,Michigan,80,-1,LOSS
1989,First Round,16,Princeton,49,1,Georgetown,50,-1,LOSS
1989,Sweet 16,1,Arizona,67,4,UNLV,68,-1,LOSS
1989,National Championship,3,Michigan,80,3,Seton Hall,79,1,WIN
1989,Final Four,3,Michigan,83,1,Illinois,81,2,WIN
1989,First Round,5,Virginia,100,12,Providence,97,3,WIN
1989,Sweet 16,3,Michigan,92,2,North Carolina,87,5,WIN
1989,First Round,3,Michigan,92,14,Xavier,87,5,WIN
1989,First Round,4,Louisville,76,13,Arkansas-Little Rock,71,5,WIN
1989,Sweet 16,5,Virginia,86,1,Oklahoma,80,6,WIN
1989,Second Round,2,Duke,70,7,West Virginia,63,7,WIN
1989,Second Round,2,North Carolina,88,7,UCLA,81,7,WIN
1989,Elite Eight,2,Duke,85,1,Georgetown,77,8,WIN
1989,Second Round,3,Michigan,91,11,South Alabama,82,9,WIN
1989,Second Round,4,Louisville,93,5,Arkansas,84,9,WIN
1989,First Round,3,Seton Hall,60,14,Missouri State,51,9,WIN
1989,First Round,7,UCLA,84,10,Iowa State,74,10,WIN
1989,First Round,11,Minnesota,86,6,Kansas State,75,11,WIN
1989,Sweet 16,3,Seton Hall,78,2,Indiana,65,13,WIN
1989,Second Round,11,Minnesota,80,14,Siena,67,13,WIN
1989,First Round,2,North Carolina,93,15,Southern,79,14,WIN
1989,Second Round,3,Seton Hall,87,11,Evansville,73,14,WIN
1989,First Round,13,Middle Tennessee State,97,4,Florida State,83,14,WIN
1989,Second Round,5,Virginia,104,13,Middle Tennessee State,88,16,WIN
1989,First Round,9,Notre Dame,81,8,Vanderbilt,65,16,WIN
1989,First Round,7,West Virginia,84,10,Tennessee,68,16,WIN
1989,Sweet 16,2,Duke,87,11,Minnesota,70,17,WIN
1989,Final Four,3,Seton Hall,95,2,Duke,78,17,WIN
1989,First Round,5,Arkansas,120,12,Loyola Marymount,101,19,WIN
1989,First Round,2,Duke,90,15,South Carolina State,69,21,WIN
1989,Elite Eight,3,Seton Hall,84,4,UNLV,61,23,WIN
1989,Second Round,1,Arizona,94,9,Clemson,68,26,WIN
1989,First Round,1,Arizona,94,16,Robert Morris,60,34,WIN
1989,Elite Eight,3,Michigan,102,5,Virginia,65,37,WIN
1990,Second Round,3,Michigan,115,11,Loyola Marymount,149,-34,LOSS
1990,National Championship,3,Duke,73,1,UNLV,103,-30,LOSS
1990,Sweet 16,8,North Carolina,73,4,Arkansas,96,-23,LOSS
1990,Second Round,2,Arizona,55,7,Alabama,77,-22,LOSS
1990,First Round,6,New Mexico State,92,11,Loyola Marymount,111,-19,LOSS
1990,First Round,14,Texas Southern,52,3,Georgetown,70,-18,LOSS
1990,First Round,13,East Tennessee State,83,4,Georgia Tech,99,-16,LOSS
1990,Final Four,4,Arkansas,83,3,Duke,97,-14,LOSS
1990,Sweet 16,6,Xavier,89,10,Texas,102,-13,LOSS
1990,Sweet 16,7,UCLA,81,3,Duke,90,-9,LOSS
1990,First Round,11,Kansas State,79,6,Xavier,87,-8,LOSS
1990,First Round,10,Notre Dame,67,7,Virginia,75,-8,LOSS
1990,First Round,12,Villanova,63,5,LSU,70,-7,LOSS
1990,First Round,13,Princeton,64,4,Arkansas,68,-4,LOSS
1990,Second Round,7,Virginia,61,2,Syracuse,63,-2,LOSS
1990,Second Round,4,Louisville,60,12,Ball State,62,-2,LOSS
1990,Elite Eight,6,Minnesota,91,4,Georgia Tech,93,-2,LOSS
1990,Second Round,12,Dayton,84,4,Arkansas,86,-2,LOSS
1990,First Round,9,Providence,83,8,Ohio State,84,-1,LOSS
1990,Second Round,2,Kansas,70,7,UCLA,71,-1,LOSS
1990,Sweet 16,1,Michigan State,80,4,Georgia Tech,81,-1,LOSS
1990,Second Round,2,Purdue,72,10,Texas,73,-1,LOSS
1990,Elite Eight,3,Duke,79,1,Connecticut,78,1,WIN
1990,Second Round,7,UCLA,71,2,Kansas,70,1,WIN
1990,Second Round,8,North Carolina,79,1,Oklahoma,77,2,WIN
1990,Second Round,4,Arkansas,86,12,Dayton,84,2,WIN
1990,First Round,12,Dayton,88,5,Illinois,86,2,WIN
1990,Elite Eight,4,Arkansas,88,10,Texas,85,3,WIN
1990,Second Round,6,Minnesota,81,14,Northern Iowa,78,3,WIN
1990,First Round,6,Minnesota,64,11,UTEP,61,3,WIN
1990,Second Round,6,Xavier,74,3,Georgetown,71,3,WIN
1990,Second Round,3,Duke,76,6,St. John's,72,4,WIN
1990,Second Round,1,Michigan State,62,9,UC Santa Barbara,58,4,WIN
1990,First Round,1,Michigan State,75,16,Murray St.,71,4,WIN
1990,First Round,4,Arkansas,68,13,Princeton,64,4,WIN
1990,First Round,3,Michigan,76,14,Illinois State,70,6,WIN
1990,Sweet 16,6,Minnesota,82,2,Syracuse,75,7,WIN
1990,First Round,7,Virginia,75,10,Notre Dame,67,8,WIN
1990,First Round,2,Kansas,79,15,Robert Morris,71,8,WIN
1990,First Round,6,Xavier,87,11,Kansas State,79,8,WIN
1990,Sweet 16,3,Duke,90,7,UCLA,81,9,WIN
1990,First Round,2,Purdue,75,15,Louisiana-Monroe,63,12,WIN
1990,First Round,7,UCLA,68,10,Alabama-Birmingham,56,12,WIN
1990,First Round,2,Arizona,79,15,South Florida,67,12,WIN
1990,First Round,8,North Carolina,83,9,Missouri State,70,13,WIN
1990,Final Four,3,Duke,97,4,Arkansas,83,14,WIN
1990,First Round,4,Louisville,78,13,Idaho,59,19,WIN
1990,Sweet 16,4,Arkansas,96,8,North Carolina,73,23,WIN
1990,First Round,3,Duke,81,14,Richmond,46,35,WIN
1991,Second Round,7,Florida State,60,2,Indiana,82,-22,LOSS
1991,First Round,5,Mississippi State,56,12,Eastern Michigan,76,-20,LOSS
1991,First Round,7,Purdue,63,10,Temple,80,-17,LOSS
1991,Second Round,14,Xavier,50,11,Connecticut,66,-16,LOSS
1991,Second Round,9,Villanova,69,1,North Carolina,84,-15,LOSS
1991,First Round,7,Virginia,48,10,Brigham Young,61,-13,LOSS
1991,Second Round,11,Creighton,69,3,Seton Hall,81,-12,LOSS
1991,Elite Eight,1,Arkansas,81,3,Kansas,93,-12,LOSS
1991,Elite Eight,3,Seton Hall,65,1,UNLV,77,-12,LOSS
1991,First Round,9,Vanderbilt,60,8,Georgetown,70,-10,LOSS
1991,Sweet 16,3,Oklahoma State,63,10,Temple,72,-9,LOSS
1991,First Round,6,New Mexico State,56,11,Creighton,64,-8,LOSS
1991,Second Round,5,Wake Forest,88,4,Alabama,96,-8,LOSS
1991,National Championship,3,Kansas,65,2,Duke,72,-7,LOSS
1991,First Round,14,New Orleans,49,3,Kansas,55,-6,LOSS
1991,First Round,14,New Orleans,49,3,Kansas,55,-6,LOSS
1991,Final Four,1,North Carolina,73,3,Kansas,79,-6,LOSS
1991,First Round,4,UCLA,69,13,Penn State,74,-5,LOSS
1991,Sweet 16,2,Arizona,77,3,Seton Hall,81,-4,LOSS
1991,First Round,10,East Tennessee State,73,7,Iowa,76,-3,LOSS
1991,First Round,10,Southern California,72,7,Florida State,75,-3,LOSS
1991,First Round,8,Princeton,48,9,Villanova,50,-2,LOSS
1991,Second Round,5,Michigan State,84,4,Utah,85,-1,LOSS
1991,First Round,9,Villanova,50,8,Princeton,48,2,WIN
1991,Final Four,2,Duke,79,1,UNLV,77,2,WIN
1991,First Round,5,Michigan State,60,12,Green Bay,58,2,WIN
1991,Elite Eight,1,North Carolina,75,10,Temple,72,3,WIN
1991,First Round,7,Florida State,75,10,Southern California,72,3,WIN
1991,Sweet 16,3,Seton Hall,81,2,Arizona,77,4,WIN
1991,First Round,14,Xavier,89,3,Nebraska,84,5,WIN
1991,Final Four,3,Kansas,79,1,North Carolina,73,6,WIN
1991,First Round,3,Kansas,55,14,New Orleans,49,6,WIN
1991,First Round,5,Wake Forest,71,12,Louisiana Tech,65,6,WIN
1991,National Championship,2,Duke,72,3,Kansas,65,7,WIN
1991,Second Round,1,Arkansas,97,8,Arizona State,90,7,WIN
1991,First Round,11,Creighton,64,6,New Mexico State,56,8,WIN
1991,Second Round,3,Oklahoma State,73,6,North Carolina State,64,9,WIN
1991,Second Round,3,Kansas,77,6,Pittsburgh,66,11,WIN
1991,Elite Eight,3,Kansas,93,1,Arkansas,81,12,WIN
1991,Second Round,3,Seton Hall,81,11,Creighton,69,12,WIN
1991,Second Round,2,Arizona,81,10,Brigham Young,69,12,WIN
1991,First Round,3,Oklahoma State,67,14,New Mexico,54,13,WIN
1991,First Round,2,Arizona,93,15,St. Francis (Pa.),80,13,WIN
1991,Sweet 16,2,Duke,81,11,Connecticut,67,14,WIN
1991,Second Round,2,Duke,85,7,Iowa,70,15,WIN
1991,Second Round,1,North Carolina,84,9,Villanova,69,15,WIN
1991,Elite Eight,2,Duke,78,4,St. John's,61,17,WIN
1991,Sweet 16,3,Kansas,83,2,Indiana,65,18,WIN
1991,First Round,3,Seton Hall,71,14,Pepperdine,51,20,WIN
1991,Sweet 16,1,Arkansas,93,4,Alabama,70,23,WIN
1991,Sweet 16,1,North Carolina,93,12,Eastern Michigan,67,26,WIN
1991,First Round,2,Duke,102,15,Louisiana-Monroe,73,29,WIN
1991,First Round,1,North Carolina,101,16,Northeastern,66,35,WIN
1991,First Round,1,Arkansas,117,16,Georgia State,76,41,WIN
1992,Elite Eight,1,UCLA,79,2,Indiana,106,-27,LOSS
1992,First Round,9,Wake Forest,58,8,Louisville,81,-23,LOSS
1992,National Championship,6,Michigan,51,1,Duke,71,-20,LOSS
1992,Second Round,8,Louisville,69,1,UCLA,85,-16,LOSS
1992,Second Round,14,East Tennessee State,90,6,Michigan,102,-12,LOSS
1992,Second Round,5,Michigan State,65,4,Cincinnati,77,-12,LOSS
1992,Sweet 16,4,Seton Hall,69,1,Duke,81,-12,LOSS
1992,First Round,12,West Virginia,78,5,Missouri,89,-11,LOSS
1992,Sweet 16,3,Florida State,74,2,Indiana,85,-11,LOSS
1992,Second Round,10,Iowa State,98,2,Kentucky,106,-8,LOSS
1992,First Round,11,Princeton,43,6,Syracuse,51,-8,LOSS
1992,Sweet 16,12,New Mexico State,78,1,UCLA,85,-7,LOSS
1992,Sweet 16,4,North Carolina,73,1,Ohio State,80,-7,LOSS
1992,First Round,3,Arizona,80,14,East Tennessee State,87,-7,LOSS
1992,Second Round,1,Kansas,60,9,UTEP,66,-6,LOSS
1992,Final Four,4,Cincinnati,72,6,Michigan,76,-4,LOSS
1992,Sweet 16,2,Oklahoma State,72,6,Michigan,75,-3,LOSS
1992,Second Round,3,Arkansas,80,6,Memphis,82,-2,LOSS
1992,Second Round,2,Southern California,78,7,Georgia Tech,79,-1,LOSS
1992,Elite Eight,2,Kentucky,103,1,Duke,104,-1,LOSS
1992,Elite Eight,1,Duke,104,2,Kentucky,103,1,WIN
1992,First Round,10,Iowa State,76,7,Charlotte,74,2,WIN
1992,First Round,4,Seton Hall,78,13,La Salle,76,2,WIN
1992,Sweet 16,4,Cincinnati,69,9,UTEP,67,2,WIN
1992,Final Four,1,Duke,81,2,Indiana,78,3,WIN
1992,Sweet 16,6,Michigan,75,2,Oklahoma State,72,3,WIN
1992,Final Four,6,Michigan,76,4,Cincinnati,72,4,WIN
1992,Elite Eight,6,Michigan,75,1,Ohio State,71,4,WIN
1992,First Round,4,North Carolina,68,13,Miami (Ohio),63,5,WIN
1992,First Round,14,East Tennessee State,87,3,Arizona,80,7,WIN
1992,First Round,5,Michigan State,61,12,Missouri State,54,7,WIN
1992,First Round,6,Michigan,73,11,Temple,66,7,WIN
1992,Sweet 16,1,UCLA,85,12,New Mexico State,78,7,WIN
1992,Second Round,12,New Mexico State,81,13,Louisiana-Lafayette,73,8,WIN
1992,First Round,12,New Mexico State,81,5,DePaul,73,8,WIN
1992,Second Round,2,Kentucky,106,10,Iowa State,98,8,WIN
1992,Second Round,4,North Carolina,64,5,Alabama,55,9,WIN
1992,Sweet 16,2,Kentucky,87,3,Massachusetts,77,10,WIN
1992,Second Round,3,Florida State,78,6,Georgetown,68,10,WIN
1992,First Round,3,Florida State,78,14,Montana,68,10,WIN
1992,First Round,3,Arkansas,80,14,Murray St.,69,11,WIN
1992,Sweet 16,1,Duke,81,4,Seton Hall,69,12,WIN
1992,Second Round,6,Michigan,102,14,East Tennessee State,90,12,WIN
1992,Second Round,4,Cincinnati,77,5,Michigan State,65,12,WIN
1992,Second Round,1,Duke,75,9,Iowa,62,13,WIN
1992,Second Round,2,Oklahoma State,87,10,Tulane,71,16,WIN
1992,Second Round,1,UCLA,85,8,Louisville,69,16,WIN
1992,Second Round,4,Seton Hall,88,5,Missouri,71,17,WIN
1992,First Round,2,Kentucky,88,15,Old Dominion,69,19,WIN
1992,National Championship,1,Duke,71,6,Michigan,51,20,WIN
1992,First Round,1,UCLA,73,16,Robert Morris,53,20,WIN
1992,First Round,8,Louisville,81,9,Wake Forest,58,23,WIN
1992,First Round,1,Duke,82,16,Campbell,56,26,WIN
1992,First Round,2,Oklahoma State,100,15,Georgia Southern,73,27,WIN
1992,First Round,2,Southern California,84,15,Louisiana-Monroe,54,30,WIN
1992,Elite Eight,4,Cincinnati,88,6,Memphis,57,31,WIN
1992,First Round,1,Kansas,100,16,Howard,67,33,WIN
1992,First Round,4,Cincinnati,85,13,Delaware,47,38,WIN
1993,Second Round,8,Rhode Island,67,1,North Carolina,112,-45,LOSS
1993,Second Round,7,New Mexico State,55,2,Cincinnati,92,-37,LOSS
1993,Sweet 16,5,Wake Forest,69,1,Kentucky,103,-34,LOSS
1993,Elite Eight,3,Florida State,81,1,Kentucky,106,-25,LOSS
1993,First Round,8,New Orleans,55,9,Xavier,73,-18,LOSS
1993,First Round,8,New Orleans,55,9,Xavier,73,-18,LOSS
1993,Sweet 16,6,Virginia,54,2,Cincinnati,71,-17,LOSS
1993,Second Round,5,Oklahoma State,63,4,Louisville,78,-15,LOSS
1993,Sweet 16,4,Louisville,69,1,Indiana,82,-13,LOSS
1993,First Round,12,Marquette,62,5,Oklahoma State,74,-12,LOSS
1993,First Round,8,Iowa State,70,9,UCLA,81,-11,LOSS
1993,Final Four,2,Kansas,68,1,North Carolina,78,-10,LOSS
1993,First Round,10,Southern Methodist,71,7,Brigham Young,80,-9,LOSS
1993,Sweet 16,3,Vanderbilt,59,7,Temple,67,-8,LOSS
1993,Elite Eight,2,Cincinnati,68,1,North Carolina,75,-7,LOSS
1993,First Round,9,Purdue,68,8,Rhode Island,74,-6,LOSS
1993,National Championship,1,Michigan,71,1,North Carolina,77,-6,LOSS
1993,Sweet 16,4,Arkansas,74,1,North Carolina,80,-6,LOSS
1993,Second Round,3,Duke,77,6,California,82,-5,LOSS
1993,Second Round,2,Seton Hall,68,7,Western Kentucky,72,-4,LOSS
1993,Final Four,1,Kentucky,78,1,Michigan,81,-3,LOSS
1993,Second Round,9,Xavier,70,1,Indiana,73,-3,LOSS
1993,First Round,2,Arizona,61,15,Santa Clara,64,-3,LOSS
1993,Second Round,9,UCLA,84,1,Michigan,86,-2,LOSS
1993,First Round,6,Kansas State,53,11,Tulane,55,-2,LOSS
1993,Second Round,1,Michigan,86,9,UCLA,84,2,WIN
1993,Final Four,1,Michigan,81,1,Kentucky,78,3,WIN
1993,Sweet 16,3,Florida State,81,7,Western Kentucky,78,3,WIN
1993,Elite Eight,1,Michigan,77,7,Temple,72,5,WIN
1993,Elite Eight,2,Kansas,83,1,Indiana,77,6,WIN
1993,First Round,8,Rhode Island,74,9,Purdue,68,6,WIN
1993,First Round,4,Louisville,76,13,Delaware,70,6,WIN
1993,National Championship,1,North Carolina,77,1,Michigan,71,6,WIN
1993,Sweet 16,1,North Carolina,80,4,Arkansas,74,6,WIN
1993,Second Round,4,Arkansas,80,5,St. John's,74,6,WIN
1993,Second Round,5,Wake Forest,84,4,Iowa,78,6,WIN
1993,Elite Eight,1,North Carolina,75,2,Cincinnati,68,7,WIN
1993,Sweet 16,1,Michigan,72,12,George Washington,64,8,WIN
1993,Final Four,1,North Carolina,78,2,Kansas,68,10,WIN
1993,First Round,9,UCLA,81,8,Iowa State,70,11,WIN
1993,First Round,6,Virginia,78,11,Manhattan,66,12,WIN
1993,First Round,5,Oklahoma State,74,12,Marquette,62,12,WIN
1993,First Round,3,Florida State,82,14,Evansville,70,12,WIN
1993,First Round,7,New Mexico State,93,10,Nebraska,79,14,WIN
1993,Second Round,2,Kansas,90,7,Brigham Young,76,14,WIN
1993,Second Round,6,Virginia,71,3,Massachusetts,56,15,WIN
1993,Second Round,4,Louisville,78,5,Oklahoma State,63,15,WIN
1993,Sweet 16,2,Kansas,93,6,California,76,17,WIN
1993,Sweet 16,2,Cincinnati,71,6,Virginia,54,17,WIN
1993,Second Round,3,Vanderbilt,85,6,Illinois,68,17,WIN
1993,First Round,9,Xavier,73,8,New Orleans,55,18,WIN
1993,First Round,1,North Carolina,85,16,East Carolina,65,20,WIN
1993,First Round,3,Vanderbilt,92,14,Boise State,72,20,WIN
1993,Second Round,1,Kentucky,83,8,Utah,62,21,WIN
1993,First Round,2,Kansas,94,15,Ball State,72,22,WIN
1993,First Round,2,Seton Hall,81,15,Tennessee State,59,22,WIN
1993,First Round,5,Wake Forest,81,12,Chattanooga,58,23,WIN
1993,Elite Eight,1,Kentucky,106,3,Florida State,81,25,WIN
1993,First Round,2,Cincinnati,93,15,Coppin State,66,27,WIN
1993,First Round,4,Arkansas,94,13,Holy Cross,64,30,WIN
1993,First Round,1,Michigan,84,16,Coastal Carolina,53,31,WIN
1993,Second Round,3,Florida State,94,11,Tulane,63,31,WIN
1993,Sweet 16,1,Kentucky,103,5,Wake Forest,69,34,WIN
1993,First Round,3,Duke,105,14,Southern Illinois,70,35,WIN
1993,Second Round,2,Cincinnati,92,7,New Mexico State,55,37,WIN
1993,First Round,1,Kentucky,96,16,Rider,52,44,WIN
1993,Second Round,1,North Carolina,112,8,Rhode Island,67,45,WIN
1994,Second Round,9,Wisconsin,96,1,Missouri,109,-13,LOSS
1994,Second Round,7,Virginia,58,2,Arizona,71,-13,LOSS
1994,Sweet 16,3,Louisville,70,2,Arizona,82,-12,LOSS
1994,First Round,15,Texas Southern,70,2,Duke,82,-12,LOSS
1994,Second Round,3,Kentucky,63,6,Marquette,75,-12,LOSS
1994,Second Round,7,Michigan State,74,2,Duke,85,-11,LOSS
1994,First Round,10,Seton Hall,73,7,Michigan State,84,-11,LOSS
1994,Second Round,5,Wake Forest,58,4,Kansas,69,-11,LOSS
1994,First Round,13,New Mexico State,55,4,Oklahoma State,65,-10,LOSS
1994,Sweet 16,6,Marquette,49,2,Duke,59,-10,LOSS
1994,First Round,5,UCLA,102,12,Tulsa,112,-10,LOSS
1994,Elite Eight,1,Purdue,60,2,Duke,69,-9,LOSS
1994,Final Four,2,Arizona,82,1,Arkansas,91,-9,LOSS
1994,Elite Eight,3,Michigan,68,1,Arkansas,76,-8,LOSS
1994,First Round,8,Cincinnati,72,9,Wisconsin,80,-8,LOSS
1994,Sweet 16,10,Maryland,71,3,Michigan,78,-7,LOSS
1994,First Round,8,Providence,70,9,Alabama,76,-6,LOSS
1994,Final Four,3,Florida,65,2,Duke,70,-5,LOSS
1994,Sweet 16,4,Kansas,78,1,Purdue,83,-5,LOSS
1994,Second Round,6,Minnesota,55,3,Louisville,60,-5,LOSS
1994,National Championship,2,Duke,72,1,Arkansas,76,-4,LOSS
1994,Second Round,1,North Carolina,72,9,Boston College,75,-3,LOSS
1994,Second Round,4,Oklahoma State,80,12,Tulsa,82,-2,LOSS
1994,First Round,3,Florida,64,14,James Madison,62,2,WIN
1994,First Round,7,Virginia,57,10,New Mexico,54,3,WIN
1994,First Round,3,Michigan,78,14,Pepperdine,74,4,WIN
1994,National Championship,1,Arkansas,76,2,Duke,72,4,WIN
1994,Final Four,2,Duke,70,3,Florida,65,5,WIN
1994,Sweet 16,1,Purdue,83,4,Kansas,78,5,WIN
1994,Second Round,3,Michigan,84,6,Texas,79,5,WIN
1994,Second Round,3,Louisville,60,6,Minnesota,55,5,WIN
1994,Sweet 16,3,Michigan,78,10,Maryland,71,7,WIN
1994,First Round,9,Wisconsin,80,8,Cincinnati,72,8,WIN
1994,Elite Eight,3,Florida,74,9,Boston College,66,8,WIN
1994,Elite Eight,1,Arkansas,76,3,Michigan,68,8,WIN
1994,Second Round,10,Maryland,95,2,Massachusetts,87,8,WIN
1994,First Round,10,Maryland,74,7,St. Louis,66,8,WIN
1994,Sweet 16,3,Florida,69,2,Connecticut,60,9,WIN
1994,Elite Eight,2,Duke,69,1,Purdue,60,9,WIN
1994,First Round,3,Louisville,67,14,Boise State,58,9,WIN
1994,Final Four,1,Arkansas,91,2,Arizona,82,9,WIN
1994,Sweet 16,2,Duke,59,6,Marquette,49,10,WIN
1994,Second Round,1,Purdue,83,9,Alabama,73,10,WIN
1994,First Round,4,Oklahoma State,65,13,New Mexico State,55,10,WIN
1994,First Round,5,Wake Forest,68,12,College of Charleston,58,10,WIN
1994,Second Round,2,Duke,85,7,Michigan State,74,11,WIN
1994,Second Round,4,Kansas,69,5,Wake Forest,58,11,WIN
1994,First Round,7,Michigan State,84,10,Seton Hall,73,11,WIN
1994,Second Round,3,Florida,70,11,Penn,58,12,WIN
1994,Second Round,6,Marquette,75,3,Kentucky,63,12,WIN
1994,First Round,2,Duke,82,15,Texas Southern,70,12,WIN
1994,Second Round,1,Arkansas,85,9,Georgetown,73,12,WIN
1994,Sweet 16,2,Arizona,82,3,Louisville,70,12,WIN
1994,First Round,3,Kentucky,83,14,Tennessee State,70,13,WIN
1994,Second Round,2,Arizona,71,7,Virginia,58,13,WIN
1994,First Round,6,Minnesota,74,11,Southern Illinois,60,14,WIN
1994,First Round,1,Arkansas,94,16,North Carolina A&T,79,15,WIN
1994,Sweet 16,1,Arkansas,103,12,Tulsa,84,19,WIN
1994,First Round,1,North Carolina,71,16,Liberty,51,20,WIN
1994,Elite Eight,2,Arizona,92,1,Missouri,72,20,WIN
1994,First Round,6,Marquette,81,11,Louisiana-Lafayette,59,22,WIN
1994,First Round,2,Arizona,81,15,Loyola (Md.),55,26,WIN
1994,First Round,4,Kansas,102,13,Chattanooga,73,29,WIN
1994,First Round,1,Purdue,98,16,Central Florida,67,31,WIN
1995,First Round,16,Mount St. Mary's,67,1,Kentucky,113,-46,LOSS
1995,First Round,14,Gonzaga,63,3,Maryland,87,-24,LOSS
1995,Second Round,7,Iowa State,51,2,North Carolina,73,-22,LOSS
1995,First Round,11,Louisville,56,6,Memphis,77,-21,LOSS
1995,Sweet 16,5,Mississippi State,67,1,UCLA,86,-19,LOSS
1995,First Round,6,Oregon,73,11,Texas,90,-17,LOSS
1995,Final Four,4,Oklahoma State,61,1,UCLA,74,-13,LOSS
1995,Elite Eight,1,Kentucky,61,2,North Carolina,74,-13,LOSS
1995,National Championship,2,Arkansas,78,1,UCLA,89,-11,LOSS
1995,Sweet 16,3,Maryland,89,2,Connecticut,99,-10,LOSS
1995,Sweet 16,1,Kansas,58,4,Virginia,67,-9,LOSS
1995,First Round,5,Arizona,62,12,Miami (Ohio),71,-9,LOSS
1995,First Round,3,Villanova,81,14,Old Dominion,89,-8,LOSS
1995,Elite Eight,4,Virginia,61,2,Arkansas,68,-7,LOSS
1995,First Round,3,Michigan State,72,14,Weber State,79,-7,LOSS
1995,Final Four,2,North Carolina,68,2,Arkansas,75,-7,LOSS
1995,First Round,9,Michigan,76,8,Western Kentucky,82,-6,LOSS
1995,Second Round,7,Cincinnati,91,2,Connecticut,96,-5,LOSS
1995,Sweet 16,1,Wake Forest,66,4,Oklahoma State,71,-5,LOSS
1995,First Round,11,Xavier,63,6,Georgetown,68,-5,LOSS
1995,First Round,10,Florida,61,7,Iowa State,64,-3,LOSS
1995,First Round,8,Minnesota,61,9,St. Louis,64,-3,LOSS
1995,Second Round,3,Purdue,73,6,Memphis,75,-2,LOSS
1995,First Round,15,Texas Southern,78,2,Arkansas,79,-1,LOSS
1995,First Round,3,Purdue,49,14,Green Bay,48,1,WIN
1995,First Round,2,Arkansas,79,15,Texas Southern,78,1,WIN
1995,Second Round,1,UCLA,75,8,Missouri,74,1,WIN
1995,Second Round,2,Arkansas,96,7,Syracuse,94,2,WIN
1995,First Round,7,Iowa State,64,10,Florida,61,3,WIN
1995,First Round,5,Mississippi State,65,12,Santa Clara,60,5,WIN
1995,Second Round,1,Kansas,75,8,Western Kentucky,70,5,WIN
1995,Sweet 16,4,Oklahoma State,71,1,Wake Forest,66,5,WIN
1995,Sweet 16,2,Arkansas,96,6,Memphis,91,5,WIN
1995,Second Round,1,Wake Forest,64,9,St. Louis,59,5,WIN
1995,Second Round,4,Virginia,60,12,Miami (Ohio),54,6,WIN
1995,Elite Eight,1,UCLA,102,2,Connecticut,96,6,WIN
1995,First Round,7,Cincinnati,77,10,Temple,71,6,WIN
1995,Final Four,2,Arkansas,75,2,North Carolina,68,7,WIN
1995,Elite Eight,2,Arkansas,68,4,Virginia,61,7,WIN
1995,Sweet 16,4,Virginia,67,1,Kansas,58,9,WIN
1995,Sweet 16,2,North Carolina,74,6,Georgetown,64,10,WIN
1995,First Round,2,North Carolina,80,15,Murray St.,70,10,WIN
1995,National Championship,1,UCLA,89,2,Arkansas,78,11,WIN
1995,Elite Eight,2,North Carolina,74,1,Kentucky,61,13,WIN
1995,Final Four,1,UCLA,74,4,Oklahoma State,61,13,WIN
1995,Second Round,5,Mississippi State,78,4,Utah,64,14,WIN
1995,First Round,1,Kansas,82,16,Colgate,68,14,WIN
1995,Elite Eight,4,Oklahoma State,68,2,Massachusetts,54,14,WIN
1995,Second Round,4,Oklahoma State,66,5,Alabama,52,14,WIN
1995,Second Round,3,Maryland,82,11,Texas,68,14,WIN
1995,Sweet 16,1,UCLA,86,5,Mississippi State,67,19,WIN
1995,Second Round,2,North Carolina,73,7,Iowa State,51,22,WIN
1995,Second Round,1,Kentucky,82,9,Tulane,60,22,WIN
1995,First Round,4,Virginia,96,13,Nicholls State,72,24,WIN
1995,First Round,4,Oklahoma State,73,13,Drexel,49,24,WIN
1995,Sweet 16,1,Kentucky,97,5,Arizona State,73,24,WIN
1995,First Round,3,Maryland,87,14,Gonzaga,63,24,WIN
1995,First Round,1,Wake Forest,79,16,North Carolina A&T,47,32,WIN
1995,First Round,1,UCLA,92,16,Florida International,56,36,WIN
1995,First Round,1,Kentucky,113,16,Mount St. Mary's,67,46,WIN
1996,Second Round,9,Virginia Tech,60,1,Kentucky,84,-24,LOSS
1996,Second Round,13,Princeton,41,5,Mississippi State,63,-22,LOSS
1996,First Round,11,New Orleans,62,6,North Carolina,83,-21,LOSS
1996,First Round,11,New Orleans,62,6,North Carolina,83,-21,LOSS
1996,First Round,10,Kansas State,48,7,New Mexico,69,-21,LOSS
1996,Elite Eight,2,Wake Forest,63,1,Kentucky,83,-20,LOSS
1996,Second Round,6,North Carolina,73,3,Texas Tech,92,-19,LOSS
1996,Sweet 16,12,Arkansas,63,1,Massachusetts,79,-16,LOSS
1996,First Round,7,Maryland,79,10,Santa Clara,91,-12,LOSS
1996,Elite Eight,2,Cincinnati,63,5,Mississippi State,73,-10,LOSS
1996,Second Round,4,Marquette,56,12,Arkansas,65,-9,LOSS
1996,Final Four,5,Mississippi State,69,4,Syracuse,77,-8,LOSS
1996,First Round,8,Duke,51,9,Eastern Michigan,58,-7,LOSS
1996,Second Round,1,Purdue,69,8,Georgia,76,-7,LOSS
1996,First Round,12,Virginia Commonwealth,51,5,Mississippi State,58,-7,LOSS
1996,Second Round,5,Iowa State,67,4,Utah,73,-6,LOSS
1996,Second Round,3,Villanova,64,6,Louisville,68,-4,LOSS
1996,First Round,7,Michigan,76,10,Texas,80,-4,LOSS
1996,Elite Eight,2,Kansas,57,4,Syracuse,60,-3,LOSS
1996,Sweet 16,3,Arizona,80,2,Kansas,83,-3,LOSS
1996,First Round,4,UCLA,41,13,Princeton,43,-2,LOSS
1996,Sweet 16,6,Louisville,59,2,Wake Forest,60,-1,LOSS
1996,Sweet 16,2,Wake Forest,60,6,Louisville,59,1,WIN
1996,First Round,1,Purdue,73,16,Western Carolina,71,2,WIN
1996,First Round,6,Louisville,82,11,Tulsa,80,2,WIN
1996,First Round,13,Princeton,43,4,UCLA,41,2,WIN
1996,Sweet 16,2,Kansas,83,3,Arizona,80,3,WIN
1996,Second Round,2,Wake Forest,65,10,Texas,62,3,WIN
1996,Second Round,6,Louisville,68,3,Villanova,64,4,WIN
1996,Sweet 16,5,Mississippi State,60,1,Connecticut,55,5,WIN
1996,First Round,2,Cincinnati,66,15,UNC Greensboro,61,5,WIN
1996,First Round,12,Arkansas,86,5,Penn State,80,6,WIN
1996,First Round,5,Mississippi State,58,12,Virginia Commonwealth,51,7,WIN
1996,Final Four,1,Kentucky,81,1,Massachusetts,74,7,WIN
1996,Second Round,12,Arkansas,65,4,Marquette,56,9,WIN
1996,National Championship,1,Kentucky,76,4,Syracuse,67,9,WIN
1996,Elite Eight,5,Mississippi State,73,2,Cincinnati,63,10,WIN
1996,First Round,5,Iowa State,74,12,California,64,10,WIN
1996,First Round,2,Wake Forest,62,15,Louisiana-Monroe,50,12,WIN
1996,First Round,9,Virginia Tech,61,8,Green Bay,48,13,WIN
1996,Second Round,2,Cincinnati,78,7,Temple,65,13,WIN
1996,Second Round,3,Arizona,87,6,Iowa,73,14,WIN
1996,Sweet 16,2,Cincinnati,87,3,Georgia Tech,70,17,WIN
1996,Elite Eight,1,Kentucky,83,2,Wake Forest,63,20,WIN
1996,First Round,6,North Carolina,83,11,New Orleans,62,21,WIN
1996,Second Round,5,Mississippi State,63,13,Princeton,41,22,WIN
1996,First Round,4,Marquette,68,13,Monmouth,44,24,WIN
1996,Second Round,1,Kentucky,84,9,Virginia Tech,60,24,WIN
1996,Second Round,2,Kansas,76,10,Santa Clara,51,25,WIN
1996,Sweet 16,1,Kentucky,101,4,Utah,70,31,WIN
1996,First Round,3,Villanova,92,14,Portland,58,34,WIN
1996,First Round,2,Kansas,92,15,South Carolina State,54,38,WIN
1996,First Round,1,Kentucky,110,16,San Jose State,72,38,WIN
1996,First Round,3,Arizona,90,14,Valparaiso,51,39,WIN
1997,Elite Eight,6,Louisville,74,1,North Carolina,97,-23,LOSS
1997,First Round,7,Marquette,59,10,Providence,81,-22,LOSS
1997,First Round,14,Butler,69,3,Cincinnati,86,-17,LOSS
1997,Second Round,8,Purdue,61,1,Kansas,75,-14,LOSS
1997,First Round,7,Wisconsin,58,10,Texas,71,-13,LOSS
1997,First Round,9,Virginia,60,8,Iowa,73,-13,LOSS
1997,First Round,11,Southern California,77,6,Illinois,90,-13,LOSS
1997,First Round,2,South Carolina,65,15,Coppin State,78,-13,LOSS
1997,Second Round,7,Xavier,83,2,UCLA,96,-13,LOSS
1997,First Round,10,Vanderbilt,68,7,Xavier,80,-12,LOSS
1997,Second Round,2,Duke,87,10,Providence,98,-11,LOSS
1997,Final Four,1,Minnesota,69,1,Kentucky,78,-9,LOSS
1997,First Round,5,Maryland,66,12,College of Charleston,75,-9,LOSS
1997,Final Four,1,North Carolina,58,4,Arizona,66,-8,LOSS
1997,Elite Eight,2,UCLA,72,1,Minnesota,80,-8,LOSS
1997,Second Round,4,Villanova,68,5,California,75,-7,LOSS
1997,First Round,9,Rhode Island,76,8,Purdue,83,-7,LOSS
1997,Second Round,3,Wake Forest,66,6,Stanford,72,-6,LOSS
1997,National Championship,1,Kentucky,79,4,Arizona,84,-5,LOSS
1997,Elite Eight,10,Providence,92,4,Arizona,96,-4,LOSS
1997,Sweet 16,1,Kansas,82,4,Arizona,85,-3,LOSS
1997,First Round,12,Princeton,52,5,California,55,-3,LOSS
1997,Sweet 16,6,Iowa State,73,2,UCLA,74,-1,LOSS
1997,Second Round,3,Cincinnati,66,6,Iowa State,67,-1,LOSS
1997,Second Round,6,Iowa State,67,3,Cincinnati,66,1,WIN
1997,Second Round,6,Louisville,64,3,New Mexico,63,1,WIN
1997,Sweet 16,2,UCLA,74,6,Iowa State,73,1,WIN
1997,First Round,2,Duke,71,15,Murray St.,68,3,WIN
1997,Sweet 16,4,Arizona,85,1,Kansas,82,3,WIN
1997,Elite Eight,4,Arizona,96,10,Providence,92,4,WIN
1997,Second Round,4,Arizona,73,12,College of Charleston,69,4,WIN
1997,National Championship,4,Arizona,84,1,Kentucky,79,5,WIN
1997,Sweet 16,10,Providence,71,14,Chattanooga,65,6,WIN
1997,Sweet 16,1,North Carolina,63,5,California,57,6,WIN
1997,Sweet 16,1,Minnesota,90,4,Clemson,84,6,WIN
1997,Second Round,1,Kentucky,75,8,Iowa,69,6,WIN
1997,First Round,8,Purdue,83,9,Rhode Island,76,7,WIN
1997,First Round,6,Louisville,65,11,Massachusetts,57,8,WIN
1997,First Round,1,North Carolina,82,16,Fairfield,74,8,WIN
1997,Elite Eight,1,Minnesota,80,2,UCLA,72,8,WIN
1997,Final Four,4,Arizona,66,1,North Carolina,58,8,WIN
1997,First Round,4,Arizona,65,13,South Alabama,57,8,WIN
1997,Final Four,1,Kentucky,78,1,Minnesota,69,9,WIN
1997,First Round,4,Villanova,101,13,Long Island,91,10,WIN
1997,Second Round,10,Providence,98,2,Duke,87,11,WIN
1997,First Round,6,Iowa State,69,11,Illinois State,57,12,WIN
1997,First Round,7,Xavier,80,10,Vanderbilt,68,12,WIN
1997,Second Round,2,UCLA,96,7,Xavier,83,13,WIN
1997,Elite Eight,1,Kentucky,72,2,Utah,59,13,WIN
1997,Second Round,1,Kansas,75,8,Purdue,61,14,WIN
1997,First Round,1,Kansas,78,16,Jackson State,64,14,WIN
1997,Sweet 16,6,Louisville,78,10,Texas,63,15,WIN
1997,Sweet 16,1,Kentucky,83,4,St. Joseph's,68,15,WIN
1997,Second Round,1,North Carolina,73,9,Colorado,56,17,WIN
1997,First Round,3,Cincinnati,86,14,Butler,69,17,WIN
1997,Second Round,1,Minnesota,76,9,Temple,57,19,WIN
1997,First Round,10,Providence,81,7,Marquette,59,22,WIN
1997,First Round,3,Wake Forest,68,14,St. Mary's (Cal.),46,22,WIN
1997,Elite Eight,1,North Carolina,97,6,Louisville,74,23,WIN
1997,First Round,1,Minnesota,78,16,Texas State,46,32,WIN
1997,First Round,2,UCLA,109,15,Charleston Southern,75,34,WIN
1997,First Round,1,Kentucky,92,16,Montana,54,38,WIN
1998,Sweet 16,6,UCLA,68,2,Kentucky,94,-26,LOSS
1998,Elite Eight,1,Arizona,51,3,Utah,76,-25,LOSS
1998,First Round,13,Butler,62,4,New Mexico,79,-17,LOSS
1998,Sweet 16,4,Michigan State,58,1,North Carolina,73,-15,LOSS
1998,Second Round,5,Princeton,51,4,Michigan State,63,-12,LOSS
1998,Sweet 16,2,Purdue,59,3,Stanford,67,-8,LOSS
1998,Sweet 16,4,Maryland,79,1,Arizona,87,-8,LOSS
1998,Second Round,8,Oklahoma State,73,1,Duke,79,-6,LOSS
1998,Final Four,1,North Carolina,59,3,Utah,65,-6,LOSS
1998,Second Round,6,Arkansas,69,3,Utah,75,-6,LOSS
1998,Second Round,12,Florida State,77,13,Valparaiso,83,-6,LOSS
1998,Second Round,1,Kansas,75,8,Rhode Island,80,-5,LOSS
1998,First Round,11,Miami (Fla.),62,6,UCLA,65,-3,LOSS
1998,Second Round,3,Michigan,82,6,UCLA,85,-3,LOSS
1998,Sweet 16,10,West Virginia,62,3,Utah,65,-3,LOSS
1998,Elite Eight,1,Duke,84,2,Kentucky,86,-2,LOSS
1998,First Round,12,Iona,61,5,Syracuse,63,-2,LOSS
1998,Elite Eight,8,Rhode Island,77,3,Stanford,79,-2,LOSS
1998,First Round,3,South Carolina,61,14,Richmond,62,-1,LOSS
1998,Second Round,2,Cincinnati,74,10,West Virginia,75,-1,LOSS
1998,First Round,6,Xavier,68,11,Washington,69,-1,LOSS
1998,Final Four,2,Kentucky,86,3,Stanford,85,1,WIN
1998,Second Round,10,West Virginia,75,2,Cincinnati,74,1,WIN
1998,Elite Eight,2,Kentucky,86,1,Duke,84,2,WIN
1998,Second Round,6,UCLA,85,3,Michigan,82,3,WIN
1998,First Round,6,UCLA,65,11,Miami (Fla.),62,3,WIN
1998,First Round,2,Cincinnati,65,15,Northern Arizona,62,3,WIN
1998,Second Round,8,Rhode Island,80,1,Kansas,75,5,WIN
1998,Second Round,1,Duke,79,8,Oklahoma State,73,6,WIN
1998,Sweet 16,8,Rhode Island,74,13,Valparaiso,68,6,WIN
1998,Second Round,4,Maryland,67,5,Illinois,61,6,WIN
1998,Sweet 16,1,Arizona,87,4,Maryland,79,8,WIN
1998,First Round,6,Arkansas,74,11,Nebraska,65,9,WIN
1998,National Championship,2,Kentucky,78,3,Utah,69,9,WIN
1998,First Round,12,Florida State,96,5,TCU,87,9,WIN
1998,Second Round,1,North Carolina,93,8,Charlotte,83,10,WIN
1998,Elite Eight,1,North Carolina,75,2,Connecticut,64,11,WIN
1998,Second Round,4,Michigan State,63,5,Princeton,51,12,WIN
1998,First Round,4,Michigan State,83,13,Eastern Michigan,71,12,WIN
1998,First Round,5,Princeton,69,12,UNLV,57,12,WIN
1998,Sweet 16,1,Duke,80,5,Syracuse,67,13,WIN
1998,First Round,4,Maryland,82,13,Utah State,68,14,WIN
1998,Second Round,2,Purdue,80,10,Detroit,65,15,WIN
1998,First Round,8,Oklahoma State,74,9,George Washington,59,15,WIN
1998,Sweet 16,1,North Carolina,73,4,Michigan State,58,15,WIN
1998,First Round,2,Kentucky,82,15,South Carolina State,67,15,WIN
1998,First Round,3,Michigan,80,14,Davidson,61,19,WIN
1998,First Round,8,Rhode Island,97,9,Murray St.,74,23,WIN
1998,Sweet 16,2,Kentucky,94,6,UCLA,68,26,WIN
1998,Second Round,2,Kentucky,88,10,St. Louis,61,27,WIN
1998,First Round,10,West Virginia,82,7,Temple,52,30,WIN
1998,Second Round,1,Arizona,82,9,Illinois State,49,33,WIN
1998,First Round,1,Duke,99,16,Radford,63,36,WIN
1998,First Round,1,North Carolina,88,16,Navy,52,36,WIN
1998,First Round,2,Purdue,95,15,Delaware,56,39,WIN
1998,First Round,1,Arizona,99,16,Nicholls State,60,39,WIN
1998,First Round,1,Kansas,110,16,Prairie View,52,58,WIN
1999,First Round,16,Winthrop,41,1,Auburn,80,-39,LOSS
1999,First Round,16,Mount St. Mary's,53,1,Michigan State,76,-23,LOSS
1999,First Round,14,New Mexico State,60,3,Kentucky,82,-22,LOSS
1999,Sweet 16,10,Purdue,55,6,Temple,77,-22,LOSS
1999,Sweet 16,2,Maryland,62,3,St. John's,76,-14,LOSS
1999,Second Round,10,Creighton,63,2,Maryland,75,-12,LOSS
1999,First Round,7,Minnesota,63,10,Gonzaga,75,-12,LOSS
1999,First Round,5,Wisconsin,32,12,Missouri State,43,-11,LOSS
1999,First Round,12,Rhode Island,70,5,Charlotte,81,-11,LOSS
1999,Second Round,2,Miami (Fla.),63,10,Purdue,73,-10,LOSS
1999,Second Round,4,Arkansas,72,5,Iowa,82,-10,LOSS
1999,Second Round,3,Cincinnati,54,6,Temple,64,-10,LOSS
1999,Second Round,9,Oklahoma State,74,1,Auburn,81,-7,LOSS
1999,First Round,11,Kent State,54,6,Temple,61,-7,LOSS
1999,Elite Eight,3,Kentucky,66,1,Michigan State,73,-7,LOSS
1999,Final Four,1,Michigan State,62,1,Duke,68,-6,LOSS
1999,Elite Eight,10,Gonzaga,62,1,Connecticut,67,-5,LOSS
1999,Second Round,6,Kansas,88,3,Kentucky,92,-4,LOSS
1999,First Round,7,Louisville,58,10,Creighton,62,-4,LOSS
1999,National Championship,1,Duke,74,1,Connecticut,77,-3,LOSS
1999,First Round,5,UCLA,53,12,Detroit,56,-3,LOSS
1999,First Round,8,Villanova,70,9,Mississippi,72,-2,LOSS
1999,First Round,3,North Carolina,74,14,Weber State,76,-2,LOSS
1999,Sweet 16,6,Florida,72,10,Gonzaga,73,-1,LOSS
1999,First Round,4,Arizona,60,13,Oklahoma,61,-1,LOSS
1999,Sweet 16,10,Gonzaga,73,6,Florida,72,1,WIN
1999,First Round,10,Purdue,58,7,Texas,54,4,WIN
1999,First Round,10,Creighton,62,7,Louisville,58,4,WIN
1999,Second Round,3,Kentucky,92,6,Kansas,88,4,WIN
1999,Final Four,1,Duke,68,1,Michigan State,62,6,WIN
1999,Elite Eight,1,Michigan State,73,3,Kentucky,66,7,WIN
1999,Second Round,6,Florida,82,14,Weber State,74,8,WIN
1999,Sweet 16,1,Michigan State,54,13,Oklahoma,46,8,WIN
1999,Second Round,1,Michigan State,74,9,Mississippi,66,8,WIN
1999,First Round,9,Oklahoma State,69,8,Syracuse,61,8,WIN
1999,Second Round,10,Gonzaga,82,2,Stanford,74,8,WIN
1999,Second Round,10,Purdue,73,2,Miami (Fla.),63,10,WIN
1999,First Round,10,Gonzaga,75,7,Minnesota,63,12,WIN
1999,Second Round,2,Maryland,75,10,Creighton,63,12,WIN
1999,First Round,6,Florida,75,11,Penn,61,14,WIN
1999,First Round,4,Arkansas,94,13,Siena,80,14,WIN
1999,Sweet 16,3,Kentucky,58,10,Miami (Ohio),43,15,WIN
1999,Sweet 16,1,Duke,78,12,Missouri State,61,17,WIN
1999,Elite Eight,1,Duke,85,6,Temple,64,21,WIN
1999,First Round,6,Kansas,95,11,Evansville,74,21,WIN
1999,First Round,2,Miami (Fla.),75,15,Lafayette,54,21,WIN
1999,First Round,3,Kentucky,82,14,New Mexico State,60,22,WIN
1999,First Round,2,Maryland,82,15,Valparaiso,60,22,WIN
1999,First Round,1,Michigan State,76,16,Mount St. Mary's,53,23,WIN
1999,First Round,3,Cincinnati,72,14,George Mason,48,24,WIN
1999,Second Round,1,Duke,97,9,Tulsa,56,41,WIN
1999,First Round,1,Duke,99,16,Florida A&M,58,41,WIN
2000,Second Round,3,Maryland,70,6,UCLA,105,-35,LOSS
2000,Sweet 16,6,UCLA,56,2,Iowa State,80,-24,LOSS
2000,First Round,15,UNC Wilmington,47,2,Cincinnati,64,-17,LOSS
2000,First Round,14,Iona,59,3,Maryland,74,-15,LOSS
2000,First Round,14,Winthrop,60,3,Oklahoma,74,-14,LOSS
2000,National Championship,5,Florida,76,1,Michigan State,89,-13,LOSS
2000,Final Four,8,Wisconsin,41,1,Michigan State,53,-12,LOSS
2000,Elite Eight,3,Oklahoma State,65,5,Florida,77,-12,LOSS
2000,Final Four,8,North Carolina,59,5,Florida,71,-12,LOSS
2000,Elite Eight,2,Iowa State,64,1,Michigan State,75,-11,LOSS
2000,First Round,7,Louisville,66,10,Gonzaga,77,-11,LOSS
2000,Sweet 16,1,Duke,78,5,Florida,87,-9,LOSS
2000,Sweet 16,6,Miami (Fla.),71,7,Tulsa,80,-9,LOSS
2000,Sweet 16,10,Gonzaga,66,6,Purdue,75,-9,LOSS
2000,Second Round,2,Cincinnati,61,7,Tulsa,69,-8,LOSS
2000,Second Round,1,Arizona,59,8,Wisconsin,66,-7,LOSS
2000,Second Round,8,Kansas,64,1,Duke,69,-5,LOSS
2000,Elite Eight,6,Purdue,60,8,Wisconsin,64,-4,LOSS
2000,First Round,11,Arkansas,71,6,Miami (Fla.),75,-4,LOSS
2000,First Round,10,Creighton,69,7,Auburn,72,-3,LOSS
2000,Sweet 16,10,Seton Hall,66,3,Oklahoma State,68,-2,LOSS
2000,Second Round,5,Kentucky,50,4,Syracuse,52,-2,LOSS
2000,First Round,7,Oregon,71,10,Seton Hall,72,-1,LOSS
2000,First Round,12,Butler,68,5,Florida,69,-1,LOSS
2000,First Round,11,Dayton,61,6,Purdue,62,-1,LOSS
2000,First Round,5,Florida,69,12,Butler,68,1,WIN
2000,First Round,6,Purdue,62,11,Dayton,61,1,WIN
2000,First Round,10,Seton Hall,72,7,Oregon,71,1,WIN
2000,Sweet 16,3,Oklahoma State,68,10,Seton Hall,66,2,WIN
2000,Second Round,10,Seton Hall,67,2,Temple,65,2,WIN
2000,Elite Eight,8,Wisconsin,64,6,Purdue,60,4,WIN
2000,First Round,8,Kansas,81,9,DePaul,77,4,WIN
2000,First Round,6,Miami (Fla.),75,11,Arkansas,71,4,WIN
2000,Second Round,6,Purdue,66,3,Oklahoma,62,4,WIN
2000,Elite Eight,8,North Carolina,59,7,Tulsa,55,4,WIN
2000,Second Round,1,Duke,69,8,Kansas,64,5,WIN
2000,First Round,1,Michigan State,61,16,Valparaiso,56,5,WIN
2000,Sweet 16,8,North Carolina,74,4,Tennessee,69,5,WIN
2000,First Round,5,Kentucky,85,12,St. Bonaventure,80,5,WIN
2000,Second Round,10,Gonzaga,82,2,St. John's,76,6,WIN
2000,Second Round,8,Wisconsin,66,1,Arizona,59,7,WIN
2000,Second Round,8,North Carolina,60,1,Stanford,53,7,WIN
2000,Second Round,3,Oklahoma State,75,11,Pepperdine,67,8,WIN
2000,Sweet 16,5,Florida,87,1,Duke,78,9,WIN
2000,Sweet 16,6,Purdue,75,10,Gonzaga,66,9,WIN
2000,First Round,8,Wisconsin,66,9,Fresno State,56,10,WIN
2000,First Round,2,Iowa State,88,15,Central Connecticut State,78,10,WIN
2000,Elite Eight,1,Michigan State,75,2,Iowa State,64,11,WIN
2000,First Round,10,Gonzaga,77,7,Louisville,66,11,WIN
2000,Final Four,5,Florida,71,8,North Carolina,59,12,WIN
2000,Elite Eight,5,Florida,77,3,Oklahoma State,65,12,WIN
2000,Final Four,1,Michigan State,53,8,Wisconsin,41,12,WIN
2000,Second Round,1,Michigan State,73,8,Utah,61,12,WIN
2000,Sweet 16,8,Wisconsin,61,4,LSU,48,13,WIN
2000,Second Round,6,Miami (Fla.),75,3,Ohio State,62,13,WIN
2000,National Championship,1,Michigan State,89,5,Florida,76,13,WIN
2000,First Round,8,North Carolina,84,9,Missouri,70,14,WIN
2000,First Round,6,UCLA,79,11,Ball State,65,14,WIN
2000,First Round,3,Maryland,74,14,Iona,59,15,WIN
2000,Second Round,5,Florida,93,4,Illinois,76,17,WIN
2000,Sweet 16,1,Michigan State,75,4,Syracuse,58,17,WIN
2000,First Round,2,Cincinnati,64,15,UNC Wilmington,47,17,WIN
2000,Second Round,2,Iowa State,79,7,Auburn,60,19,WIN
2000,First Round,3,Oklahoma State,86,14,Hofstra,66,20,WIN
2000,Sweet 16,2,Iowa State,80,6,UCLA,56,24,WIN
2000,First Round,1,Arizona,71,16,Jackson State,47,24,WIN
2000,First Round,1,Duke,85,16,Lamar,55,30,WIN
2000,Second Round,6,UCLA,105,3,Maryland,70,35,WIN
2001,Second Round,13,Kent State,43,5,Cincinnati,66,-23,LOSS
2001,First Round,15,Princeton,48,2,North Carolina,70,-22,LOSS
2001,Second Round,3,Florida,54,11,Temple,75,-21,LOSS
2001,Second Round,10,Butler,52,2,Arizona,73,-21,LOSS
2001,Final Four,1,Michigan State,61,2,Arizona,80,-19,LOSS
2001,Sweet 16,4,Kansas,64,1,Illinois,80,-16,LOSS
2001,First Round,7,Wake Forest,63,10,Butler,79,-16,LOSS
2001,First Round,11,Oklahoma State,54,6,Southern California,69,-15,LOSS
2001,Sweet 16,12,Gonzaga,62,1,Michigan State,77,-15,LOSS
2001,First Round,10,Creighton,56,7,Iowa,69,-13,LOSS
2001,Sweet 16,4,UCLA,63,1,Duke,76,-13,LOSS
2001,Sweet 16,5,Cincinnati,65,1,Stanford,78,-13,LOSS
2001,First Round,11,Xavier,71,6,Notre Dame,83,-12,LOSS
2001,Final Four,3,Maryland,84,1,Duke,95,-11,LOSS
2001,First Round,10,Providence,59,7,Penn State,69,-10,LOSS
2001,Elite Eight,6,Southern California,69,1,Duke,79,-10,LOSS
2001,National Championship,2,Arizona,72,1,Duke,82,-10,LOSS
2001,Second Round,2,North Carolina,74,7,Penn State,82,-8,LOSS
2001,Play-In,16,Winthrop,67,16,Northwestern State,71,-4,LOSS
2001,Sweet 16,2,Kentucky,76,6,Southern California,80,-4,LOSS
2001,Second Round,6,Notre Dame,56,3,Mississippi,59,-3,LOSS
2001,First Round,14,Iona,70,3,Mississippi,72,-2,LOSS
2001,First Round,7,Arkansas,61,10,Georgetown,63,-2,LOSS
2001,First Round,6,Wisconsin,49,11,Georgia State,50,-1,LOSS
2001,First Round,5,Virginia,85,12,Gonzaga,86,-1,LOSS
2001,First Round,2,Iowa State,57,15,Hampton,58,-1,LOSS
2001,First Round,12,Gonzaga,86,5,Virginia,85,1,WIN
2001,Second Round,6,Southern California,74,3,Boston College,71,3,WIN
2001,First Round,3,Maryland,83,14,George Mason,80,3,WIN
2001,Sweet 16,6,Southern California,80,2,Kentucky,76,4,WIN
2001,First Round,13,Kent State,77,4,Indiana,73,4,WIN
2001,First Round,2,Kentucky,72,15,Holy Cross,68,4,WIN
2001,Elite Eight,2,Arizona,87,1,Illinois,81,6,WIN
2001,Elite Eight,1,Michigan State,69,11,Temple,62,7,WIN
2001,National Championship,1,Duke,82,2,Arizona,72,10,WIN
2001,Elite Eight,1,Duke,79,6,Southern California,69,10,WIN
2001,Sweet 16,3,Maryland,76,10,Georgetown,66,10,WIN
2001,Sweet 16,2,Arizona,66,3,Mississippi,56,10,WIN
2001,Final Four,1,Duke,95,3,Maryland,84,11,WIN
2001,First Round,6,Notre Dame,83,11,Xavier,71,12,WIN
2001,First Round,3,Florida,69,14,Western Kentucky,56,13,WIN
2001,Sweet 16,1,Duke,76,4,UCLA,63,13,WIN
2001,Second Round,1,Duke,94,9,Missouri,81,13,WIN
2001,First Round,4,UCLA,61,13,Hofstra,48,13,WIN
2001,Second Round,2,Kentucky,92,7,Iowa,79,13,WIN
2001,Elite Eight,3,Maryland,87,1,Stanford,73,14,WIN
2001,First Round,6,Southern California,69,11,Oklahoma State,54,15,WIN
2001,Sweet 16,1,Michigan State,77,12,Gonzaga,62,15,WIN
2001,Second Round,1,Michigan State,81,9,Fresno State,65,16,WIN
2001,First Round,10,Butler,79,7,Wake Forest,63,16,WIN
2001,Second Round,12,Gonzaga,85,13,Indiana State,68,17,WIN
2001,Second Round,3,Maryland,79,11,Georgia State,60,19,WIN
2001,Final Four,2,Arizona,80,1,Michigan State,61,19,WIN
2001,Second Round,2,Arizona,73,10,Butler,52,21,WIN
2001,First Round,2,North Carolina,70,15,Princeton,48,22,WIN
2001,Second Round,5,Cincinnati,66,13,Kent State,43,23,WIN
2001,First Round,4,Kansas,99,13,Cal State Northridge,75,24,WIN
2001,Second Round,4,UCLA,75,12,Utah State,50,25,WIN
2001,First Round,5,Cincinnati,84,12,Brigham Young,59,25,WIN
2001,First Round,2,Arizona,101,15,Eastern Illinois,76,25,WIN
2001,Second Round,4,Kansas,87,5,Syracuse,58,29,WIN
2001,First Round,1,Michigan State,69,16,Alabama State,35,34,WIN
2001,First Round,1,Duke,95,16,Monmouth,52,43,WIN
2002,First Round,16,Winthrop,37,1,Duke,84,-47,LOSS
2002,Second Round,8,Wisconsin,57,1,Maryland,87,-30,LOSS
2002,Sweet 16,3,Arizona,67,2,Oklahoma,88,-21,LOSS
2002,Elite Eight,2,Oregon,86,1,Kansas,104,-18,LOSS
2002,First Round,5,Miami (Fla.),80,12,Missouri,93,-13,LOSS
2002,Second Round,7,Xavier,65,2,Oklahoma,78,-13,LOSS
2002,Second Round,12,Creighton,60,4,Illinois,72,-12,LOSS
2002,Elite Eight,10,Kent State,69,5,Indiana,81,-12,LOSS
2002,First Round,10,Michigan State,58,7,North Carolina State,69,-11,LOSS
2002,Sweet 16,4,Kentucky,68,1,Maryland,78,-10,LOSS
2002,Second Round,13,UNC Wilmington,67,5,Indiana,76,-9,LOSS
2002,Final Four,1,Kansas,88,1,Maryland,97,-9,LOSS
2002,Sweet 16,8,UCLA,73,12,Missouri,82,-9,LOSS
2002,First Round,7,Oklahoma State,61,10,Kent State,69,-8,LOSS
2002,First Round,6,Gonzaga,66,11,Wyoming,73,-7,LOSS
2002,Second Round,8,Notre Dame,77,1,Duke,84,-7,LOSS
2002,Second Round,7,Wake Forest,87,2,Oregon,92,-5,LOSS
2002,Second Round,3,Mississippi State,64,6,Texas,68,-4,LOSS
2002,First Round,4,Southern California,89,13,UNC Wilmington,93,-4,LOSS
2002,Second Round,1,Cincinnati,101,8,UCLA,105,-4,LOSS
2002,First Round,5,Marquette,69,12,Tulsa,71,-2,LOSS
2002,First Round,5,Florida,82,12,Creighton,83,-1,LOSS
2002,Sweet 16,1,Duke,73,5,Indiana,74,-1,LOSS
2002,First Round,12,Creighton,83,5,Florida,82,1,WIN
2002,Sweet 16,2,Oregon,72,6,Texas,70,2,WIN
2002,First Round,13,UNC Wilmington,93,4,Southern California,89,4,WIN
2002,Sweet 16,1,Kansas,73,4,Illinois,69,4,WIN
2002,Second Round,8,UCLA,105,1,Cincinnati,101,4,WIN
2002,Second Round,2,Oregon,92,7,Wake Forest,87,5,WIN
2002,Sweet 16,10,Kent State,78,3,Pittsburgh,73,5,WIN
2002,Second Round,4,Kentucky,87,12,Tulsa,82,5,WIN
2002,First Round,3,Arizona,86,14,UC Santa Barbara,81,5,WIN
2002,Second Round,1,Duke,84,8,Notre Dame,77,7,WIN
2002,First Round,10,Kent State,69,7,Oklahoma State,61,8,WIN
2002,Elite Eight,1,Maryland,90,2,Connecticut,82,8,WIN
2002,Second Round,3,Arizona,68,11,Wyoming,60,8,WIN
2002,First Round,7,Wake Forest,83,10,Pepperdine,74,9,WIN
2002,Final Four,1,Maryland,97,1,Kansas,88,9,WIN
2002,First Round,8,Wisconsin,80,9,St. John's,70,10,WIN
2002,Sweet 16,1,Maryland,78,4,Kentucky,68,10,WIN
2002,First Round,1,Kansas,70,16,Holy Cross,59,11,WIN
2002,First Round,3,Mississippi State,70,14,McNeese State,58,12,WIN
2002,National Championship,1,Maryland,64,5,Indiana,52,12,WIN
2002,First Round,7,Xavier,70,10,Hawaii,58,12,WIN
2002,Second Round,10,Kent State,71,2,Alabama,58,13,WIN
2002,First Round,4,Kentucky,83,13,Valparaiso,68,15,WIN
2002,First Round,1,Maryland,85,16,Siena,70,15,WIN
2002,Elite Eight,1,Kansas,104,2,Oregon,86,18,WIN
2002,First Round,2,Oregon,81,15,Montana,62,19,WIN
2002,First Round,8,Notre Dame,82,9,Charlotte,63,19,WIN
2002,First Round,8,UCLA,80,9,Mississippi,58,22,WIN
2002,Second Round,1,Kansas,86,8,Stanford,63,23,WIN
2002,Second Round,1,Maryland,87,8,Wisconsin,57,30,WIN
2002,First Round,1,Cincinnati,90,16,Boston University,52,38,WIN
2002,First Round,1,Duke,84,16,Winthrop,37,47,WIN
2003,Final Four,3,Marquette,61,2,Kansas,94,-33,LOSS
2003,First Round,16,Vermont,51,1,Arizona,80,-29,LOSS
2003,Second Round,2,Florida,46,7,Michigan State,68,-22,LOSS
2003,Sweet 16,5,Notre Dame,71,1,Arizona,88,-17,LOSS
2003,Elite Eight,1,Kentucky,69,3,Marquette,83,-14,LOSS
2003,First Round,4,Dayton,71,13,Tulsa,84,-13,LOSS
2003,Second Round,3,Xavier,64,6,Maryland,77,-13,LOSS
2003,First Round,14,Troy,59,3,Xavier,71,-12,LOSS
2003,Second Round,6,Oklahoma State,56,3,Syracuse,68,-12,LOSS
2003,Sweet 16,12,Butler,54,1,Oklahoma,65,-11,LOSS
2003,Second Round,9,Purdue,67,1,Texas,77,-10,LOSS
2003,Elite Eight,7,Michigan State,76,1,Texas,85,-9,LOSS
2003,Second Round,4,Louisville,71,12,Butler,79,-8,LOSS
2003,Play-In,16,Texas Southern,84,16,UNC Asheville,92,-8,LOSS
2003,Sweet 16,5,Wisconsin,57,1,Kentucky,63,-6,LOSS
2003,First Round,6,Creighton,73,11,Central Michigan,79,-6,LOSS
2003,Second Round,2,Wake Forest,62,10,Auburn,68,-6,LOSS
2003,First Round,8,Cincinnati,69,9,Gonzaga,74,-5,LOSS
2003,Sweet 16,3,Duke,65,2,Kansas,69,-4,LOSS
2003,First Round,15,East Tennessee State,73,2,Wake Forest,76,-3,LOSS
2003,National Championship,2,Kansas,78,3,Syracuse,81,-3,LOSS
2003,Elite Eight,1,Arizona,75,2,Kansas,78,-3,LOSS
2003,First Round,11,UNC Wilmington,73,6,Maryland,75,-2,LOSS
2003,First Round,8,Oregon,58,9,Utah,60,-2,LOSS
2003,Sweet 16,6,Maryland,58,7,Michigan State,60,-2,LOSS
2003,First Round,5,Mississippi State,46,12,Butler,47,-1,LOSS
2003,Second Round,9,Gonzaga,95,1,Arizona,96,-1,LOSS
2003,Second Round,5,Wisconsin,61,13,Tulsa,60,1,WIN
2003,First Round,12,Butler,47,5,Mississippi State,46,1,WIN
2003,First Round,5,Notre Dame,70,12,Milwaukee,69,1,WIN
2003,Second Round,1,Arizona,96,9,Gonzaga,95,1,WIN
2003,Sweet 16,7,Michigan State,60,6,Maryland,58,2,WIN
2003,First Round,6,Maryland,75,11,UNC Wilmington,73,2,WIN
2003,Sweet 16,3,Marquette,77,2,Pittsburgh,74,3,WIN
2003,Elite Eight,2,Kansas,78,1,Arizona,75,3,WIN
2003,First Round,2,Kansas,64,15,Utah State,61,3,WIN
2003,First Round,2,Wake Forest,76,15,East Tennessee State,73,3,WIN
2003,First Round,3,Marquette,72,14,Holy Cross,68,4,WIN
2003,Sweet 16,2,Kansas,69,3,Duke,65,4,WIN
2003,First Round,9,Gonzaga,74,8,Cincinnati,69,5,WIN
2003,Second Round,3,Duke,86,11,Central Michigan,80,6,WIN
2003,Sweet 16,1,Kentucky,63,5,Wisconsin,57,6,WIN
2003,First Round,5,Wisconsin,81,12,Weber State,74,7,WIN
2003,Second Round,12,Butler,79,4,Louisville,71,8,WIN
2003,Second Round,5,Notre Dame,68,4,Illinois,60,8,WIN
2003,Second Round,3,Marquette,101,6,Missouri,92,9,WIN
2003,First Round,3,Duke,67,14,Colorado State,57,10,WIN
2003,First Round,3,Xavier,71,14,Troy,59,12,WIN
2003,Second Round,6,Maryland,77,3,Xavier,64,13,WIN
2003,Elite Eight,3,Marquette,83,1,Kentucky,69,14,WIN
2003,First Round,6,Oklahoma State,77,11,Penn,63,14,WIN
2003,First Round,7,Michigan State,79,10,Colorado,64,15,WIN
2003,Sweet 16,1,Arizona,88,5,Notre Dame,71,17,WIN
2003,Second Round,1,Kentucky,74,9,Utah,54,20,WIN
2003,Second Round,7,Michigan State,68,2,Florida,46,22,WIN
2003,First Round,4,Louisville,86,13,Austin Peay,64,22,WIN
2003,First Round,9,Purdue,80,8,LSU,56,24,WIN
2003,First Round,1,Arizona,80,16,Vermont,51,29,WIN
2003,First Round,2,Florida,85,15,Sam Houston State,55,30,WIN
2003,First Round,1,Kentucky,95,16,IUPUI,64,31,WIN
2003,Second Round,2,Kansas,108,10,Arizona State,76,32,WIN
2003,Final Four,2,Kansas,94,3,Marquette,61,33,WIN
2004,Second Round,8,Seton Hall,62,1,Duke,90,-28,LOSS
2004,Second Round,4,Cincinnati,68,5,Illinois,92,-24,LOSS
2004,Sweet 16,6,Vanderbilt,53,2,Connecticut,73,-20,LOSS
2004,Second Round,2,Gonzaga,72,10,Nevada,91,-19,LOSS
2004,First Round,15,Vermont,53,2,Connecticut,70,-17,LOSS
2004,First Round,10,South Carolina,43,7,Memphis,59,-16,LOSS
2004,Second Round,2,Mississippi State,74,7,Xavier,89,-15,LOSS
2004,First Round,5,Florida,60,12,Manhattan,75,-15,LOSS
2004,First Round,10,Louisville,70,7,Xavier,80,-10,LOSS
2004,First Round,14,Princeton,70,3,Texas,80,-10,LOSS
2004,First Round,5,Providence,58,12,Pacific,66,-8,LOSS
2004,Elite Eight,4,Kansas,71,3,Georgia Tech,79,-8,LOSS
2004,First Round,10,Dayton,69,7,DePaul,76,-7,LOSS
2004,First Round,7,Michigan State,66,10,Nevada,72,-6,LOSS
2004,Sweet 16,10,Nevada,67,3,Georgia Tech,72,-5,LOSS
2004,Second Round,6,Wisconsin,55,3,Pittsburgh,59,-4,LOSS
2004,Sweet 16,4,Wake Forest,80,1,St. Joseph's,84,-4,LOSS
2004,First Round,9,Arizona,76,8,Seton Hall,80,-4,LOSS
2004,First Round,13,East Tennessee State,77,4,Cincinnati,80,-3,LOSS
2004,Second Round,6,North Carolina,75,3,Texas,78,-3,LOSS
2004,Elite Eight,7,Xavier,63,1,Duke,66,-3,LOSS
2004,Final Four,2,Oklahoma State,65,3,Georgia Tech,67,-2,LOSS
2004,Second Round,4,Maryland,70,5,Syracuse,72,-2,LOSS
2004,Final Four,1,Duke,78,2,Connecticut,79,-1,LOSS
2004,Second Round,1,Kentucky,75,9,Alabama-Birmingham,76,-1,LOSS
2004,First Round,13,Virginia Commonwealth,78,4,Wake Forest,79,-1,LOSS
2004,First Round,4,Wake Forest,79,13,Virginia Commonwealth,78,1,WIN
2004,Elite Eight,2,Oklahoma State,64,1,St. Joseph's,62,2,WIN
2004,Second Round,6,Vanderbilt,75,3,North Carolina State,73,2,WIN
2004,Elite Eight,1,Duke,66,7,Xavier,63,3,WIN
2004,First Round,4,Cincinnati,80,13,East Tennessee State,77,3,WIN
2004,First Round,4,Maryland,86,13,UTEP,83,3,WIN
2004,First Round,8,Seton Hall,80,9,Arizona,76,4,WIN
2004,Second Round,4,Wake Forest,84,12,Manhattan,80,4,WIN
2004,First Round,10,Nevada,72,7,Michigan State,66,6,WIN
2004,Sweet 16,7,Xavier,79,3,Texas,71,8,WIN
2004,First Round,2,Mississippi State,80,15,Monmouth,70,10,WIN
2004,Sweet 16,1,Duke,72,5,Illinois,62,10,WIN
2004,First Round,7,Xavier,80,10,Louisville,70,10,WIN
2004,First Round,6,North Carolina,63,11,Air Force,52,11,WIN
2004,First Round,6,Wisconsin,76,11,Richmond,64,12,WIN
2004,Sweet 16,2,Oklahoma State,63,3,Pittsburgh,51,12,WIN
2004,First Round,6,Vanderbilt,71,11,Western Michigan,58,13,WIN
2004,Second Round,4,Kansas,78,12,Pacific,63,15,WIN
2004,Second Round,7,Xavier,89,2,Mississippi State,74,15,WIN
2004,Second Round,2,Oklahoma State,70,7,Memphis,53,17,WIN
2004,Second Round,10,Nevada,91,2,Gonzaga,72,19,WIN
2004,First Round,2,Oklahoma State,75,15,Eastern Washington,56,19,WIN
2004,First Round,1,Kentucky,96,16,Florida A&M,76,20,WIN
2004,First Round,4,Kansas,78,13,Illinois-Chicago,53,25,WIN
2004,Sweet 16,4,Kansas,100,9,Alabama-Birmingham,74,26,WIN
2004,First Round,2,Gonzaga,76,15,Valparaiso,49,27,WIN
2004,Second Round,1,Duke,90,8,Seton Hall,62,28,WIN
2004,First Round,1,Duke,96,16,Alabama State,61,35,WIN
2005,Second Round,9,Iowa State,65,1,North Carolina,92,-27,LOSS
2005,Final Four,4,Louisville,58,1,Illinois,75,-17,LOSS
2005,Final Four,5,Michigan State,71,1,North Carolina,87,-16,LOSS
2005,Second Round,9,Nevada,59,1,Illinois,71,-12,LOSS
2005,First Round,11,UCLA,66,6,Texas Tech,78,-12,LOSS
2005,Second Round,4,Florida,65,5,Villanova,76,-11,LOSS
2005,Second Round,13,Vermont,61,5,Michigan State,72,-11,LOSS
2005,First Round,8,Minnesota,53,9,Iowa State,64,-11,LOSS
2005,Sweet 16,1,Duke,68,5,Michigan State,78,-10,LOSS
2005,First Round,14,Winthrop,64,3,Gonzaga,74,-10,LOSS
2005,Second Round,7,Cincinnati,60,2,Kentucky,69,-9,LOSS
2005,Second Round,14,Bucknell,62,6,Wisconsin,71,-9,LOSS
2005,Second Round,9,Mississippi State,55,1,Duke,63,-8,LOSS
2005,Elite Eight,7,West Virginia,85,4,Louisville,93,-8,LOSS
2005,Elite Eight,6,Wisconsin,82,1,North Carolina,88,-6,LOSS
2005,Second Round,2,Wake Forest,105,7,West Virginia,111,-6,LOSS
2005,Elite Eight,2,Kentucky,88,5,Michigan State,94,-6,LOSS
2005,First Round,10,Creighton,61,7,West Virginia,63,-2,LOSS
2005,Second Round,3,Gonzaga,69,6,Texas Tech,71,-2,LOSS
2005,Sweet 16,5,Villanova,66,1,North Carolina,67,-1,LOSS
2005,First Round,3,Kansas,63,14,Bucknell,64,-1,LOSS
2005,Sweet 16,2,Oklahoma State,78,3,Arizona,79,-1,LOSS
2005,Elite Eight,3,Arizona,89,1,Illinois,90,-1,LOSS
2005,Sweet 16,1,North Carolina,67,5,Villanova,66,1,WIN
2005,First Round,14,Bucknell,64,3,Kansas,63,1,WIN
2005,Sweet 16,3,Arizona,79,2,Oklahoma State,78,1,WIN
2005,First Round,7,West Virginia,63,10,Creighton,61,2,WIN
2005,First Round,13,Vermont,60,4,Syracuse,57,3,WIN
2005,First Round,9,Nevada,61,8,Texas,57,4,WIN
2005,First Round,6,Wisconsin,57,11,Northern Iowa,52,5,WIN
2005,First Round,4,Florida,67,13,Ohio,62,5,WIN
2005,National Championship,1,North Carolina,75,1,Illinois,70,5,WIN
2005,Sweet 16,7,West Virginia,65,6,Texas Tech,60,5,WIN
2005,Elite Eight,5,Michigan State,94,2,Kentucky,88,6,WIN
2005,First Round,4,Louisville,68,13,Louisiana-Lafayette,62,6,WIN
2005,Elite Eight,1,North Carolina,88,6,Wisconsin,82,6,WIN
2005,Second Round,7,West Virginia,111,2,Wake Forest,105,6,WIN
2005,First Round,5,Villanova,55,12,New Mexico,47,8,WIN
2005,Second Round,1,Duke,63,9,Mississippi State,55,8,WIN
2005,First Round,5,Michigan State,89,12,Old Dominion,81,8,WIN
2005,Second Round,2,Oklahoma State,85,7,Southern Illinois,77,8,WIN
2005,Elite Eight,4,Louisville,93,7,West Virginia,85,8,WIN
2005,First Round,2,Kentucky,72,15,Eastern Kentucky,64,8,WIN
2005,Sweet 16,6,Wisconsin,65,10,North Carolina State,56,9,WIN
2005,Second Round,6,Wisconsin,71,14,Bucknell,62,9,WIN
2005,Second Round,2,Kentucky,69,7,Cincinnati,60,9,WIN
2005,Sweet 16,5,Michigan State,78,1,Duke,68,10,WIN
2005,Sweet 16,2,Kentucky,62,6,Utah,52,10,WIN
2005,First Round,3,Gonzaga,74,14,Winthrop,64,10,WIN
2005,Second Round,5,Villanova,76,4,Florida,65,11,WIN
2005,First Round,1,Duke,57,16,Delaware State,46,11,WIN
2005,Second Round,5,Michigan State,72,13,Vermont,61,11,WIN
2005,First Round,9,Iowa State,64,8,Minnesota,53,11,WIN
2005,First Round,7,Cincinnati,76,10,Iowa,64,12,WIN
2005,First Round,2,Oklahoma State,63,15,Southeastern Louisiana,50,13,WIN
2005,First Round,3,Arizona,66,14,Utah State,53,13,WIN
2005,Sweet 16,4,Louisville,93,1,Washington,79,14,WIN
2005,Final Four,1,North Carolina,87,5,Michigan State,71,16,WIN
2005,First Round,2,Wake Forest,70,15,Chattanooga,54,16,WIN
2005,Second Round,4,Louisville,76,5,Georgia Tech,54,22,WIN
2005,Second Round,3,Arizona,85,11,Alabama-Birmingham,63,22,WIN
2005,First Round,9,Mississippi State,93,8,Stanford,70,23,WIN
2005,Second Round,1,North Carolina,92,9,Iowa State,65,27,WIN
2005,First Round,1,North Carolina,96,16,Oakland,68,28,WIN
2006,First Round,10,Seton Hall,66,7,Wichita State,86,-20,LOSS
2006,First Round,9,Wisconsin,75,8,Arizona,94,-19,LOSS
2006,First Round,13,Iona,64,4,LSU,80,-16,LOSS
2006,National Championship,2,UCLA,57,3,Florida,73,-16,LOSS
2006,Second Round,9,Bucknell,56,1,Memphis,72,-16,LOSS
2006,First Round,12,Kent State,64,5,Pittsburgh,79,-15,LOSS
2006,Elite Eight,1,Villanova,62,3,Florida,75,-13,LOSS
2006,First Round,6,Michigan State,65,11,George Mason,75,-10,LOSS
2006,Sweet 16,1,Duke,54,4,LSU,62,-8,LOSS
2006,First Round,5,Nevada,79,12,Montana,87,-8,LOSS
2006,Sweet 16,7,Wichita State,55,11,George Mason,63,-8,LOSS
2006,First Round,7,Marquette,85,10,Alabama,90,-5,LOSS
2006,Second Round,3,North Carolina,60,11,George Mason,65,-5,LOSS
2006,First Round,4,Kansas,73,13,Bradley,77,-4,LOSS
2006,First Round,8,Arkansas,55,9,Bucknell,59,-4,LOSS
2006,Second Round,8,Kentucky,83,1,Connecticut,87,-4,LOSS
2006,First Round,14,Xavier,75,3,Gonzaga,79,-4,LOSS
2006,Second Round,8,Arizona,78,1,Villanova,82,-4,LOSS
2006,First Round,9,UNC Wilmington,85,8,George Washington,88,-3,LOSS
2006,Sweet 16,6,West Virginia,71,2,Texas,74,-3,LOSS
2006,First Round,15,Winthrop,61,2,Tennessee,63,-2,LOSS
2006,Sweet 16,3,Gonzaga,71,2,UCLA,73,-2,LOSS
2006,Sweet 16,1,Villanova,60,4,Boston College,59,1,WIN
2006,Sweet 16,2,UCLA,73,3,Gonzaga,71,2,WIN
2006,Second Round,2,UCLA,62,10,Alabama,59,3,WIN
2006,Second Round,1,Villanova,82,8,Arizona,78,4,WIN
2006,Sweet 16,3,Florida,57,7,Georgetown,53,4,WIN
2006,First Round,3,North Carolina,69,14,Murray St.,65,4,WIN
2006,First Round,3,Gonzaga,79,14,Xavier,75,4,WIN
2006,First Round,9,Bucknell,59,8,Arkansas,55,4,WIN
2006,Elite Eight,2,UCLA,50,1,Memphis,45,5,WIN
2006,Second Round,1,Duke,70,8,George Washington,64,6,WIN
2006,Second Round,7,Wichita State,80,2,Tennessee,73,7,WIN
2006,Second Round,3,Gonzaga,90,6,Indiana,80,10,WIN
2006,First Round,1,Villanova,58,16,Monmouth,45,13,WIN
2006,Elite Eight,3,Florida,75,1,Villanova,62,13,WIN
2006,First Round,8,Kentucky,72,9,Alabama-Birmingham,59,13,WIN
2006,Second Round,6,West Virginia,67,14,Northwestern State,54,13,WIN
2006,Final Four,2,UCLA,59,4,LSU,45,14,WIN
2006,Final Four,3,Florida,73,11,George Mason,58,15,WIN
2006,National Championship,3,Florida,73,2,UCLA,57,16,WIN
2006,First Round,1,Duke,70,16,Southern,54,16,WIN
2006,First Round,6,West Virginia,64,11,Southern Illinois,46,18,WIN
2006,First Round,8,Arizona,94,9,Wisconsin,75,19,WIN
2006,First Round,7,Wichita State,86,10,Seton Hall,66,20,WIN
2006,Second Round,3,Florida,82,11,Milwaukee,60,22,WIN
2006,First Round,3,Florida,76,14,South Alabama,50,26,WIN
2006,First Round,2,UCLA,78,15,Belmont,44,34,WIN
2007,First Round,12,Arkansas,60,5,Southern California,77,-17,LOSS
2007,Second Round,7,Nevada,62,2,Memphis,78,-16,LOSS
2007,Second Round,5,Virginia Tech,48,4,Southern Illinois,63,-15,LOSS
2007,Second Round,9,Michigan State,67,1,North Carolina,81,-14,LOSS
2007,Second Round,11,Winthrop,61,3,Oregon,75,-14,LOSS
2007,Elite Eight,1,Kansas,55,2,UCLA,68,-13,LOSS
2007,First Round,10,Gonzaga,57,7,Indiana,70,-13,LOSS
2007,First Round,13,New Mexico State,67,4,Texas,79,-12,LOSS
2007,First Round,8,Marquette,49,9,Michigan State,61,-12,LOSS
2007,Elite Eight,1,North Carolina,84,2,Georgetown,96,-12,LOSS
2007,Second Round,8,Kentucky,76,1,Kansas,88,-12,LOSS
2007,Sweet 16,5,Southern California,64,1,North Carolina,74,-10,LOSS
2007,Final Four,2,UCLA,66,1,Florida,76,-10,LOSS
2007,First Round,6,Notre Dame,64,11,Winthrop,74,-10,LOSS
2007,First Round,9,Villanova,58,8,Kentucky,67,-9,LOSS
2007,First Round,8,Arizona,63,9,Purdue,72,-9,LOSS
2007,Elite Eight,3,Oregon,77,1,Florida,85,-8,LOSS
2007,Sweet 16,5,Butler,57,1,Florida,65,-8,LOSS
2007,Second Round,9,Purdue,67,1,Florida,74,-7,LOSS
2007,Second Round,9,Xavier,71,1,Ohio State,78,-7,LOSS
2007,Second Round,2,Wisconsin,68,7,UNLV,74,-6,LOSS
2007,First Round,10,Creighton,71,7,Nevada,77,-6,LOSS
2007,Second Round,11,Virginia Commonwealth,79,3,Pittsburgh,84,-5,LOSS
2007,Second Round,4,Virginia,74,5,Tennessee,77,-3,LOSS
2007,Second Round,6,Louisville,69,3,Texas A&M,72,-3,LOSS
2007,Second Round,4,Maryland,59,5,Butler,62,-3,LOSS
2007,First Round,6,Duke,77,11,Virginia Commonwealth,79,-2,LOSS
2007,Sweet 16,6,Vanderbilt,65,2,Georgetown,66,-1,LOSS
2007,First Round,5,Virginia Tech,54,12,Illinois,52,2,WIN
2007,First Round,3,Oregon,58,14,Miami (Ohio),56,2,WIN
2007,First Round,9,Xavier,79,8,Brigham Young,77,2,WIN
2007,First Round,11,Virginia Commonwealth,79,6,Duke,77,2,WIN
2007,Sweet 16,1,Kansas,61,4,Southern Illinois,58,3,WIN
2007,Second Round,5,Butler,62,4,Maryland,59,3,WIN
2007,Sweet 16,3,Oregon,76,7,UNLV,72,4,WIN
2007,Second Round,6,Vanderbilt,78,3,Washington State,74,4,WIN
2007,Second Round,2,UCLA,54,7,Indiana,49,5,WIN
2007,First Round,7,Nevada,77,10,Creighton,71,6,WIN
2007,Second Round,1,Florida,74,9,Purdue,67,7,WIN
2007,Elite Eight,1,Florida,85,3,Oregon,77,8,WIN
2007,Sweet 16,1,Florida,65,5,Butler,57,8,WIN
2007,National Championship,1,Florida,84,1,Ohio State,75,9,WIN
2007,First Round,9,Purdue,72,8,Arizona,63,9,WIN
2007,Sweet 16,2,UCLA,64,3,Pittsburgh,55,9,WIN
2007,First Round,8,Kentucky,67,9,Villanova,58,9,WIN
2007,Final Four,1,Florida,76,2,UCLA,66,10,WIN
2007,Sweet 16,1,North Carolina,74,5,Southern California,64,10,WIN
2007,First Round,11,Winthrop,74,6,Notre Dame,64,10,WIN
2007,First Round,5,Butler,57,12,Old Dominion,46,11,WIN
2007,Second Round,1,Kansas,88,8,Kentucky,76,12,WIN
2007,First Round,9,Michigan State,61,8,Marquette,49,12,WIN
2007,First Round,4,Maryland,82,13,Davidson,70,12,WIN
2007,First Round,2,Wisconsin,76,15,Texas A&M-Corpus Christi,63,13,WIN
2007,Elite Eight,2,UCLA,68,1,Kansas,55,13,WIN
2007,Second Round,3,Oregon,75,11,Winthrop,61,14,WIN
2007,Second Round,1,North Carolina,81,9,Michigan State,67,14,WIN
2007,First Round,5,Southern California,77,12,Arkansas,60,17,WIN
2007,Second Round,5,Southern California,87,4,Texas,68,19,WIN
2007,First Round,6,Louisville,78,11,Stanford,58,20,WIN
2007,First Round,1,North Carolina,86,16,Eastern Kentucky,65,21,WIN
2007,First Round,4,Virginia,84,13,Albany (N.Y.),57,27,WIN
2007,First Round,2,UCLA,70,15,Weber State,42,28,WIN
2007,First Round,6,Vanderbilt,77,11,George Washington,44,33,WIN
2007,First Round,1,Kansas,107,16,Niagara,67,40,WIN
2007,First Round,1,Florida,112,16,Jackson State,69,43,WIN
2008,First Round,16,Mount St. Mary's,74,1,North Carolina,113,-39,LOSS
2008,Second Round,9,Arkansas,77,1,North Carolina,108,-31,LOSS
2008,First Round,13,Winthrop,40,4,Washington State,71,-31,LOSS
2008,First Round,4,Vanderbilt,62,13,Siena,83,-21,LOSS
2008,Second Round,5,Notre Dame,41,4,Washington State,61,-20,LOSS
2008,Elite Eight,3,Xavier,57,1,UCLA,76,-19,LOSS
2008,Sweet 16,5,Michigan State,74,1,Memphis,92,-18,LOSS
2008,Final Four,1,North Carolina,66,1,Kansas,84,-18,LOSS
2008,Sweet 16,3,Wisconsin,56,10,Davidson,73,-17,LOSS
2008,Second Round,11,Kansas State,55,3,Wisconsin,72,-17,LOSS
2008,Sweet 16,12,Villanova,57,1,Kansas,72,-15,LOSS
2008,Final Four,1,UCLA,63,1,Memphis,78,-15,LOSS
2008,First Round,6,Southern California,67,11,Kansas State,80,-13,LOSS
2008,First Round,9,Kent State,58,8,UNLV,71,-13,LOSS
2008,Elite Eight,3,Louisville,73,1,North Carolina,83,-10,LOSS
2008,First Round,10,Arizona,65,7,West Virginia,75,-10,LOSS
2008,First Round,11,Kentucky,66,6,Marquette,74,-8,LOSS
2008,Second Round,6,Purdue,78,3,Xavier,85,-7,LOSS
2008,First Round,9,Oregon,69,8,Mississippi State,76,-7,LOSS
2008,Second Round,2,Duke,67,7,West Virginia,73,-6,LOSS
2008,First Round,7,Gonzaga,76,10,Davidson,82,-6,LOSS
2008,Second Round,7,Butler,71,2,Tennessee,76,-5,LOSS
2008,Sweet 16,7,West Virginia,75,3,Xavier,79,-4,LOSS
2008,Second Round,8,Mississippi State,74,1,Memphis,77,-3,LOSS
2008,Second Round,7,Miami (Fla.),72,2,Texas,75,-3,LOSS
2008,Second Round,6,Marquette,81,3,Stanford,82,-1,LOSS
2008,First Round,2,Duke,71,15,Belmont,70,1,WIN
2008,Elite Eight,1,Kansas,59,10,Davidson,57,2,WIN
2008,Second Round,1,UCLA,51,9,Texas A&M,49,2,WIN
2008,Sweet 16,3,Xavier,79,7,West Virginia,75,4,WIN
2008,First Round,12,Villanova,75,5,Clemson,69,6,WIN
2008,Second Round,7,West Virginia,73,2,Duke,67,6,WIN
2008,First Round,8,Mississippi State,76,9,Oregon,69,7,WIN
2008,National Championship,1,Kansas,75,1,Memphis,68,7,WIN
2008,Second Round,3,Xavier,85,6,Purdue,78,7,WIN
2008,First Round,6,Marquette,74,11,Kentucky,66,8,WIN
2008,Play-In,16,Mount St. Mary's,69,16,Coppin State,60,9,WIN
2008,Elite Eight,1,North Carolina,83,3,Louisville,73,10,WIN
2008,Sweet 16,1,UCLA,88,12,Western Kentucky,78,10,WIN
2008,First Round,7,West Virginia,75,10,Arizona,65,10,WIN
2008,Second Round,5,Michigan State,65,4,Pittsburgh,54,11,WIN
2008,First Round,5,Michigan State,72,12,Temple,61,11,WIN
2008,First Round,6,Purdue,90,11,Baylor,79,11,WIN
2008,Second Round,12,Villanova,84,13,Siena,72,12,WIN
2008,First Round,3,Xavier,73,14,Georgia,61,12,WIN
2008,First Round,11,Kansas State,80,6,Southern California,67,13,WIN
2008,First Round,7,Miami (Fla.),78,10,St. Mary's (Cal.),64,14,WIN
2008,First Round,9,Arkansas,86,8,Indiana,72,14,WIN
2008,First Round,3,Wisconsin,71,14,Cal State Fullerton,56,15,WIN
2008,Sweet 16,1,Kansas,72,12,Villanova,57,15,WIN
2008,Second Round,3,Wisconsin,72,11,Kansas State,55,17,WIN
2008,Final Four,1,Kansas,84,1,North Carolina,66,18,WIN
2008,First Round,3,Louisville,79,14,Boise State,61,18,WIN
2008,First Round,5,Notre Dame,68,12,George Mason,50,18,WIN
2008,Second Round,1,Kansas,75,8,UNLV,56,19,WIN
2008,Sweet 16,3,Louisville,79,2,Tennessee,60,19,WIN
2008,Elite Eight,1,UCLA,76,3,Xavier,57,19,WIN
2008,First Round,7,Butler,81,10,South Alabama,61,20,WIN
2008,Sweet 16,1,North Carolina,68,4,Washington State,47,21,WIN
2008,First Round,1,Kansas,85,16,Portland State,61,24,WIN
2008,Second Round,3,Louisville,78,6,Oklahoma,48,30,WIN
2008,Second Round,1,North Carolina,108,9,Arkansas,77,31,WIN
2008,First Round,1,North Carolina,113,16,Mount St. Mary's,74,39,WIN
2008,First Round,1,UCLA,70,16,Mississippi Valley State,29,41,WIN
2009,Sweet 16,12,Arizona,64,1,Louisville,103,-39,LOSS
2009,Sweet 16,2,Duke,54,3,Villanova,77,-23,LOSS
2009,Sweet 16,4,Gonzaga,77,1,North Carolina,98,-21,LOSS
2009,Second Round,6,UCLA,69,3,Villanova,89,-20,LOSS
2009,Second Round,10,Maryland,70,2,Memphis,89,-19,LOSS
2009,National Championship,2,Michigan State,72,1,North Carolina,89,-17,LOSS
2009,Second Round,11,Dayton,43,3,Kansas,60,-17,LOSS
2009,First Round,4,Wake Forest,69,13,Cleveland State,84,-15,LOSS
2009,Final Four,3,Villanova,69,1,North Carolina,83,-14,LOSS
2009,First Round,10,Minnesota,62,7,Texas,76,-14,LOSS
2009,First Round,13,Mississippi State,58,4,Washington,71,-13,LOSS
2009,Sweet 16,5,Purdue,60,1,Connecticut,72,-12,LOSS
2009,Elite Eight,1,Louisville,52,2,Michigan State,64,-12,LOSS
2009,Second Round,12,Wisconsin,49,4,Xavier,60,-11,LOSS
2009,First Round,16,East Tennessee State,62,1,Pittsburgh,72,-10,LOSS
2009,Second Round,10,Michigan,63,2,Oklahoma,73,-10,LOSS
2009,Second Round,8,Oklahoma State,76,1,Pittsburgh,84,-8,LOSS
2009,First Round,6,West Virginia,60,11,Dayton,68,-8,LOSS
2009,Second Round,10,Southern California,69,2,Michigan State,74,-5,LOSS
2009,Sweet 16,3,Kansas,62,2,Michigan State,67,-5,LOSS
2009,Sweet 16,4,Xavier,55,1,Pittsburgh,60,-5,LOSS
2009,Second Round,6,Marquette,79,3,Missouri,83,-4,LOSS
2009,First Round,9,Butler,71,8,LSU,75,-4,LOSS
2009,First Round,5,Florida State,59,12,Wisconsin,61,-2,LOSS
2009,First Round,11,Virginia Commonwealth,64,6,UCLA,65,-1,LOSS
2009,First Round,6,Marquette,58,11,Utah State,57,1,WIN
2009,First Round,6,UCLA,65,11,Virginia Commonwealth,64,1,WIN
2009,Elite Eight,3,Villanova,78,1,Pittsburgh,76,2,WIN
2009,First Round,12,Wisconsin,61,5,Florida State,59,2,WIN
2009,Second Round,5,Purdue,76,4,Washington,74,2,WIN
2009,First Round,8,Oklahoma State,77,9,Tennessee,75,2,WIN
2009,Second Round,4,Gonzaga,83,12,Western Kentucky,81,2,WIN
2009,First Round,10,Michigan,62,7,Clemson,59,3,WIN
2009,Second Round,2,Duke,74,7,Texas,69,5,WIN
2009,Sweet 16,2,Michigan State,67,3,Kansas,62,5,WIN
2009,Second Round,2,Michigan State,74,10,Southern California,69,5,WIN
2009,First Round,5,Purdue,61,12,Northern Iowa,56,5,WIN
2009,First Round,11,Dayton,68,6,West Virginia,60,8,WIN
2009,Final Four,2,Michigan State,82,1,Connecticut,73,9,WIN
2009,First Round,3,Kansas,84,14,North Dakota State,74,10,WIN
2009,Second Round,4,Xavier,60,12,Wisconsin,49,11,WIN
2009,Elite Eight,2,Michigan State,64,1,Louisville,52,12,WIN
2009,Elite Eight,1,North Carolina,72,2,Oklahoma,60,12,WIN
2009,First Round,3,Villanova,80,14,American,67,13,WIN
2009,First Round,4,Gonzaga,77,13,Akron,64,13,WIN
2009,First Round,10,Maryland,84,7,California,71,13,WIN
2009,First Round,12,Arizona,84,5,Utah,71,13,WIN
2009,Final Four,1,North Carolina,83,3,Villanova,69,14,WIN
2009,Second Round,1,North Carolina,84,8,LSU,70,14,WIN
2009,Second Round,12,Arizona,71,13,Cleveland State,57,14,WIN
2009,First Round,2,Michigan State,77,15,Robert Morris,62,15,WIN
2009,First Round,10,Southern California,72,7,Boston College,55,17,WIN
2009,Second Round,3,Kansas,60,11,Dayton,43,17,WIN
2009,Second Round,1,Louisville,79,9,Siena,62,17,WIN
2009,National Championship,1,North Carolina,89,2,Michigan State,72,17,WIN
2009,First Round,4,Xavier,77,13,Portland State,59,18,WIN
2009,Second Round,3,Villanova,89,6,UCLA,69,20,WIN
2009,First Round,1,Louisville,74,16,Morehead State,54,20,WIN
2009,Sweet 16,1,North Carolina,98,4,Gonzaga,77,21,WIN
2009,Sweet 16,3,Villanova,77,2,Duke,54,23,WIN
2009,First Round,2,Duke,86,15,Binghamton,62,24,WIN
2009,Sweet 16,1,Louisville,103,12,Arizona,64,39,WIN
2009,First Round,1,North Carolina,101,16,Radford,58,43,WIN
2010,Second Round,9,Wake Forest,60,1,Kentucky,90,-30,LOSS
2010,First Round,16,East Tennessee State,71,1,Kentucky,100,-29,LOSS
2010,First Round,16,Vermont,56,1,Syracuse,79,-23,LOSS
2010,Second Round,8,Gonzaga,65,1,Syracuse,87,-22,LOSS
2010,Final Four,2,West Virginia,57,1,Duke,78,-21,LOSS
2010,Second Round,4,Wisconsin,69,12,Cornell,87,-18,LOSS
2010,Play-In,16,Winthrop,44,16,Arkansas-Pine Bluff,61,-17,LOSS
2010,First Round,9,Louisville,62,8,California,77,-15,LOSS
2010,Sweet 16,4,Purdue,57,1,Duke,70,-13,LOSS
2010,First Round,11,Minnesota,54,6,Xavier,65,-11,LOSS
2010,Second Round,2,Villanova,68,10,St. Mary's (Cal.),75,-7,LOSS
2010,First Round,10,Florida,92,7,Brigham Young,99,-7,LOSS
2010,Elite Eight,2,Kansas State,56,5,Butler,63,-7,LOSS
2010,Elite Eight,1,Kentucky,66,2,West Virginia,73,-7,LOSS
2010,First Round,9,Florida State,60,8,Gonzaga,67,-7,LOSS
2010,First Round,7,Oklahoma State,59,10,Georgia Tech,64,-5,LOSS
2010,Sweet 16,6,Xavier,96,2,Kansas State,101,-5,LOSS
2010,First Round,12,New Mexico State,67,5,Michigan State,70,-3,LOSS
2010,First Round,6,Marquette,78,11,Washington,80,-2,LOSS
2010,Second Round,1,Kansas,67,9,Northern Iowa,69,-2,LOSS
2010,Final Four,5,Michigan State,50,5,Butler,52,-2,LOSS
2010,National Championship,5,Butler,59,1,Duke,61,-2,LOSS
2010,Second Round,4,Maryland,83,5,Michigan State,85,-2,LOSS
2010,First Round,4,Vanderbilt,65,13,Murray St.,66,-1,LOSS
2010,First Round,6,Notre Dame,50,11,Old Dominion,51,-1,LOSS
2010,Elite Eight,5,Michigan State,70,6,Tennessee,69,1,WIN
2010,First Round,9,Wake Forest,81,8,Texas,80,1,WIN
2010,National Championship,1,Duke,61,5,Butler,59,2,WIN
2010,Second Round,5,Michigan State,85,4,Maryland,83,2,WIN
2010,Second Round,4,Purdue,63,5,Texas A&M,61,2,WIN
2010,Final Four,5,Butler,52,5,Michigan State,50,2,WIN
2010,Second Round,5,Butler,54,13,Murray St.,52,2,WIN
2010,First Round,2,Villanova,73,15,Robert Morris,70,3,WIN
2010,First Round,5,Michigan State,70,12,New Mexico State,67,3,WIN
2010,Second Round,6,Xavier,71,3,Pittsburgh,68,3,WIN
2010,First Round,4,Wisconsin,53,13,Wofford,49,4,WIN
2010,Sweet 16,5,Butler,63,1,Syracuse,59,4,WIN
2010,Sweet 16,2,Kansas State,101,6,Xavier,96,5,WIN
2010,Elite Eight,1,Duke,78,3,Baylor,71,7,WIN
2010,Sweet 16,5,Michigan State,59,9,Northern Iowa,52,7,WIN
2010,Elite Eight,5,Butler,63,2,Kansas State,56,7,WIN
2010,First Round,8,Gonzaga,67,9,Florida State,60,7,WIN
2010,Elite Eight,2,West Virginia,73,1,Kentucky,66,7,WIN
2010,First Round,4,Purdue,72,13,Siena,64,8,WIN
2010,Second Round,2,West Virginia,68,10,Missouri,59,9,WIN
2010,First Round,6,Xavier,65,11,Minnesota,54,11,WIN
2010,Second Round,2,Kansas State,84,7,Brigham Young,72,12,WIN
2010,First Round,4,Maryland,89,13,Houston,77,12,WIN
2010,Sweet 16,1,Duke,70,4,Purdue,57,13,WIN
2010,Sweet 16,2,West Virginia,69,11,Washington,56,13,WIN
2010,Second Round,1,Duke,68,8,California,53,15,WIN
2010,First Round,1,Kansas,90,16,Lehigh,74,16,WIN
2010,Sweet 16,1,Kentucky,62,12,Cornell,45,17,WIN
2010,First Round,5,Butler,77,12,UTEP,59,18,WIN
2010,First Round,2,Kansas State,82,15,North Texas,62,20,WIN
2010,Final Four,1,Duke,78,2,West Virginia,57,21,WIN
2010,First Round,2,West Virginia,77,15,Morgan State,50,27,WIN
2010,First Round,1,Duke,73,16,Arkansas-Pine Bluff,44,29,WIN
2010,First Round,1,Kentucky,100,16,East Tennessee State,71,29,WIN
2010,Second Round,1,Kentucky,90,9,Wake Forest,60,30,WIN
2011,First Round,14,Bucknell,52,3,Connecticut,81,-29,LOSS
2011,Second Round,11,Gonzaga,67,3,Brigham Young,89,-22,LOSS
2011,Sweet 16,11,Marquette,63,2,North Carolina,81,-18,LOSS
2011,Second Round,3,Purdue,76,11,Virginia Commonwealth,94,-18,LOSS
2011,Sweet 16,1,Duke,77,5,Arizona,93,-16,LOSS
2011,Second Round,2,Notre Dame,57,10,Florida State,71,-14,LOSS
2011,Play-In,11,Southern California,46,11,Virginia Commonwealth,59,-13,LOSS
2011,National Championship,8,Butler,41,3,Connecticut,53,-12,LOSS
2011,Second Round,6,Cincinnati,58,3,Connecticut,69,-11,LOSS
2011,First Round,6,Xavier,55,11,Marquette,66,-11,LOSS
2011,Elite Eight,1,Kansas,61,11,Virginia Commonwealth,71,-10,LOSS
2011,Second Round,7,UCLA,65,2,Florida,73,-8,LOSS
2011,Second Round,5,West Virginia,63,4,Kentucky,71,-8,LOSS
2011,Final Four,11,Virginia Commonwealth,62,8,Butler,70,-8,LOSS
2011,Sweet 16,4,Wisconsin,54,8,Butler,61,-7,LOSS
2011,Elite Eight,2,North Carolina,69,4,Kentucky,76,-7,LOSS
2011,Second Round,5,Kansas State,65,4,Wisconsin,70,-5,LOSS
2011,First Round,9,Villanova,57,8,George Mason,61,-4,LOSS
2011,Elite Eight,2,Florida,71,8,Butler,74,-3,LOSS
2011,First Round,5,Vanderbilt,66,12,Richmond,69,-3,LOSS
2011,First Round,10,Michigan State,76,7,UCLA,78,-2,LOSS
2011,Second Round,8,Michigan,71,1,Duke,73,-2,LOSS
2011,First Round,13,Princeton,57,4,Kentucky,59,-2,LOSS
2011,Elite Eight,5,Arizona,63,3,Connecticut,65,-2,LOSS
2011,First Round,4,Louisville,61,13,Morehead State,62,-1,LOSS
2011,Final Four,4,Kentucky,55,3,Connecticut,56,-1,LOSS
2011,Sweet 16,10,Florida State,71,11,Virginia Commonwealth,72,-1,LOSS
2011,Second Round,8,Butler,71,1,Pittsburgh,70,1,WIN
2011,Sweet 16,11,Virginia Commonwealth,72,10,Florida State,71,1,WIN
2011,Second Round,5,Arizona,70,4,Texas,69,1,WIN
2011,Second Round,1,Duke,73,8,Michigan,71,2,WIN
2011,First Round,8,Butler,60,9,Old Dominion,58,2,WIN
2011,First Round,7,UCLA,78,10,Michigan State,76,2,WIN
2011,Sweet 16,4,Kentucky,62,1,Ohio State,60,2,WIN
2011,First Round,4,Kentucky,59,13,Princeton,57,2,WIN
2011,First Round,5,Arizona,77,12,Memphis,75,2,WIN
2011,Second Round,2,North Carolina,86,7,Washington,83,3,WIN
2011,Elite Eight,8,Butler,74,2,Florida,71,3,WIN
2011,Second Round,11,Marquette,66,3,Syracuse,62,4,WIN
2011,Second Round,4,Wisconsin,70,5,Kansas State,65,5,WIN
2011,First Round,5,Kansas State,73,12,Utah State,68,5,WIN
2011,Sweet 16,8,Butler,61,4,Wisconsin,54,7,WIN
2011,Elite Eight,4,Kentucky,76,2,North Carolina,69,7,WIN
2011,First Round,10,Florida State,57,7,Texas A&M,50,7,WIN
2011,Second Round,2,Florida,73,7,UCLA,65,8,WIN
2011,Final Four,8,Butler,70,11,Virginia Commonwealth,62,8,WIN
2011,Second Round,4,Kentucky,71,5,West Virginia,63,8,WIN
2011,First Round,5,West Virginia,84,12,Clemson,76,8,WIN
2011,Sweet 16,2,Florida,83,3,Brigham Young,74,9,WIN
2011,Elite Eight,11,Virginia Commonwealth,71,1,Kansas,61,10,WIN
2011,First Round,11,Marquette,66,6,Xavier,55,11,WIN
2011,First Round,2,Notre Dame,69,15,Akron,56,13,WIN
2011,Play-In,11,Virginia Commonwealth,59,11,Southern California,46,13,WIN
2011,First Round,4,Wisconsin,72,13,Belmont,58,14,WIN
2011,Second Round,1,Kansas,73,9,Illinois,59,14,WIN
2011,Second Round,10,Florida State,71,2,Notre Dame,57,14,WIN
2011,First Round,2,North Carolina,102,15,Long Island,87,15,WIN
2011,First Round,6,Cincinnati,78,11,Missouri,63,15,WIN
2011,First Round,11,Gonzaga,86,6,St. John's,71,15,WIN
2011,Sweet 16,5,Arizona,93,1,Duke,77,16,WIN
2011,Sweet 16,2,North Carolina,81,11,Marquette,63,18,WIN
2011,Second Round,11,Virginia Commonwealth,94,3,Purdue,76,18,WIN
2011,First Round,11,Virginia Commonwealth,74,6,Georgetown,56,18,WIN
2011,First Round,1,Kansas,72,16,Boston University,53,19,WIN
2011,Sweet 16,1,Kansas,77,12,Richmond,57,20,WIN
2011,First Round,3,Purdue,65,14,St. Peter's,43,22,WIN
2011,First Round,2,Florida,79,15,UC Santa Barbara,51,28,WIN
2011,First Round,8,Michigan,75,9,Tennessee,45,30,WIN
2011,First Round,1,Duke,87,16,Hampton,45,42,WIN
2012,First Round,10,Virginia,45,7,Florida,71,-26,LOSS
2012,First Round,10,West Virginia,54,7,Gonzaga,77,-23,LOSS
2012,First Round,16,Vermont,58,1,North Carolina,77,-19,LOSS
2012,Second Round,8,Iowa State,71,1,Kentucky,87,-16,LOSS
2012,Second Round,8,Kansas State,59,1,Syracuse,75,-16,LOSS
2012,Sweet 16,6,Cincinnati,66,2,Ohio State,81,-15,LOSS
2012,Second Round,8,Creighton,73,1,North Carolina,87,-14,LOSS
2012,First Round,13,New Mexico State,66,4,Indiana,79,-13,LOSS
2012,Sweet 16,1,Michigan State,44,4,Louisville,57,-13,LOSS
2012,Elite Eight,1,North Carolina,67,2,Kansas,80,-13,LOSS
2012,Sweet 16,3,Marquette,58,7,Florida,68,-10,LOSS
2012,National Championship,2,Kansas,59,1,Kentucky,67,-8,LOSS
2012,Final Four,4,Louisville,61,1,Kentucky,69,-8,LOSS
2012,First Round,14,South Dakota State,60,3,Baylor,68,-8,LOSS
2012,Second Round,7,Gonzaga,66,2,Ohio State,73,-7,LOSS
2012,Play-In,14,Iona,72,14,Brigham Young,78,-6,LOSS
2012,Second Round,3,Florida State,56,6,Cincinnati,62,-6,LOSS
2012,First Round,2,Duke,70,15,Lehigh,75,-5,LOSS
2012,First Round,4,Michigan,60,13,Ohio,65,-5,LOSS
2012,Sweet 16,10,Xavier,70,3,Baylor,75,-5,LOSS
2012,Elite Eight,7,Florida,68,4,Louisville,72,-4,LOSS
2012,First Round,7,Notre Dame,63,10,Xavier,67,-4,LOSS
2012,Second Round,10,Purdue,60,2,Kansas,63,-3,LOSS
2012,First Round,5,Wichita State,59,12,Virginia Commonwealth,62,-3,LOSS
2012,Second Round,5,Vanderbilt,57,4,Wisconsin,60,-3,LOSS
2012,Second Round,12,Virginia Commonwealth,61,4,Indiana,63,-2,LOSS
2012,Sweet 16,4,Wisconsin,63,1,Syracuse,64,-1,LOSS
2012,First Round,8,Creighton,58,9,Alabama,57,1,WIN
2012,Final Four,2,Kansas,64,2,Ohio State,62,2,WIN
2012,Second Round,4,Wisconsin,60,5,Vanderbilt,57,3,WIN
2012,Sweet 16,2,Kansas,60,11,North Carolina State,57,3,WIN
2012,Second Round,2,Kansas,63,10,Purdue,60,3,WIN
2012,First Round,10,Purdue,72,7,St. Mary's (Cal.),69,3,WIN
2012,Second Round,4,Louisville,59,5,New Mexico,56,3,WIN
2012,First Round,3,Florida State,66,14,St. Bonaventure,63,3,WIN
2012,First Round,12,Virginia Commonwealth,62,5,Wichita State,59,3,WIN
2012,Second Round,1,Michigan State,65,9,St. Louis,61,4,WIN
2012,Elite Eight,4,Louisville,72,7,Florida,68,4,WIN
2012,First Round,10,Xavier,67,7,Notre Dame,63,4,WIN
2012,Second Round,6,Cincinnati,62,3,Florida State,56,6,WIN
2012,First Round,6,Cincinnati,65,11,Texas,59,6,WIN
2012,First Round,8,Kansas State,70,9,Southern Mississippi,64,6,WIN
2012,First Round,4,Louisville,69,13,Davidson,62,7,WIN
2012,Sweet 16,1,North Carolina,73,13,Ohio,65,8,WIN
2012,National Championship,1,Kentucky,67,2,Kansas,59,8,WIN
2012,Final Four,1,Kentucky,69,4,Louisville,61,8,WIN
2012,Second Round,3,Marquette,62,6,Murray St.,53,9,WIN
2012,First Round,5,Vanderbilt,79,12,Harvard,70,9,WIN
2012,Sweet 16,7,Florida,68,3,Marquette,58,10,WIN
2012,Play-In,16,Vermont,71,16,Lamar,59,12,WIN
2012,Elite Eight,1,Kentucky,82,3,Baylor,70,12,WIN
2012,Sweet 16,1,Kentucky,102,4,Indiana,90,12,WIN
2012,Second Round,10,Xavier,70,15,Lehigh,58,12,WIN
2012,Elite Eight,2,Kansas,80,1,North Carolina,67,13,WIN
2012,First Round,8,Iowa State,77,9,Connecticut,64,13,WIN
2012,Sweet 16,4,Louisville,57,1,Michigan State,44,13,WIN
2012,Second Round,1,North Carolina,87,8,Creighton,73,14,WIN
2012,First Round,2,Kansas,65,15,Detroit,50,15,WIN
2012,First Round,1,Kentucky,81,16,Western Kentucky,66,15,WIN
2012,Second Round,1,Kentucky,87,8,Iowa State,71,16,WIN
2012,First Round,1,North Carolina,77,16,Vermont,58,19,WIN
2012,First Round,3,Marquette,88,14,Brigham Young,68,20,WIN
2012,First Round,1,Michigan State,89,16,Long Island,67,22,WIN
2012,First Round,7,Gonzaga,77,10,West Virginia,54,23,WIN
2012,First Round,4,Wisconsin,73,13,Montana,49,24,WIN
2012,First Round,7,Florida,71,10,Virginia,45,26,WIN
2012,Second Round,7,Florida,84,15,Norfolk State,50,34,WIN
2013,First Round,15,Iona,70,2,Ohio State,95,-25,LOSS
2013,Second Round,5,Virginia Commonwealth,53,4,Michigan,78,-25,LOSS
2013,Elite Eight,2,Duke,63,1,Louisville,85,-22,LOSS
2013,Elite Eight,3,Florida,59,4,Michigan,79,-20,LOSS
2013,First Round,13,New Mexico State,44,4,St. Louis,64,-20,LOSS
2013,First Round,6,UCLA,63,11,Minnesota,83,-20,LOSS
2013,First Round,7,Notre Dame,58,10,Iowa State,76,-18,LOSS
2013,Elite Eight,3,Marquette,39,4,Syracuse,55,-16,LOSS
2013,Second Round,7,Creighton,50,2,Duke,66,-16,LOSS
2013,First Round,13,South Dakota State,56,4,Michigan,71,-15,LOSS
2013,Second Round,11,Minnesota,64,3,Florida,78,-14,LOSS
2013,First Round,5,Oklahoma State,55,12,Oregon,68,-13,LOSS
2013,Play-In,11,Middle Tennessee State,54,11,St. Mary's (Cal.),67,-13,LOSS
2013,Second Round,8,North Carolina,58,1,Kansas,70,-12,LOSS
2013,First Round,11,Bucknell,56,6,Butler,68,-12,LOSS
2013,Sweet 16,15,Florida Gulf Coast,50,3,Florida,62,-12,LOSS
2013,First Round,5,Wisconsin,46,12,Mississippi,57,-11,LOSS
2013,Sweet 16,2,Miami (Fla.),61,3,Marquette,71,-10,LOSS
2013,Sweet 16,3,Michigan State,61,2,Duke,71,-10,LOSS
2013,Sweet 16,12,Oregon,69,1,Louisville,77,-8,LOSS
2013,First Round,9,Villanova,71,8,North Carolina,78,-7,LOSS
2013,National Championship,4,Michigan,76,1,Louisville,82,-6,LOSS
2013,Second Round,1,Gonzaga,70,9,Wichita State,76,-6,LOSS
2013,First Round,10,Cincinnati,63,7,Creighton,67,-4,LOSS
2013,Final Four,9,Wichita State,68,1,Louisville,72,-4,LOSS
2013,Second Round,10,Iowa State,75,2,Ohio State,78,-3,LOSS
2013,Sweet 16,6,Arizona,70,2,Ohio State,73,-3,LOSS
2013,Sweet 16,1,Kansas,85,4,Michigan,87,-2,LOSS
2013,Second Round,6,Butler,72,3,Marquette,74,-2,LOSS
2013,First Round,4,Kansas State,61,13,La Salle,63,-2,LOSS
2013,First Round,3,Marquette,59,14,Davidson,58,1,WIN
2013,Second Round,3,Marquette,74,6,Butler,72,2,WIN
2013,Sweet 16,4,Michigan,87,1,Kansas,85,2,WIN
2013,Second Round,2,Miami (Fla.),63,7,Illinois,59,4,WIN
2013,First Round,7,Creighton,67,10,Cincinnati,63,4,WIN
2013,Final Four,1,Louisville,72,9,Wichita State,68,4,WIN
2013,Elite Eight,9,Wichita State,70,2,Ohio State,66,4,WIN
2013,Final Four,4,Michigan,61,4,Syracuse,56,5,WIN
2013,National Championship,1,Louisville,82,4,Michigan,76,6,WIN
2013,Second Round,9,Wichita State,76,1,Gonzaga,70,6,WIN
2013,First Round,1,Gonzaga,64,16,Southern,58,6,WIN
2013,First Round,1,Kansas,64,16,Western Kentucky,57,7,WIN
2013,First Round,8,North Carolina,78,9,Villanova,71,7,WIN
2013,Sweet 16,1,Louisville,77,12,Oregon,69,8,WIN
2013,Sweet 16,3,Marquette,71,2,Miami (Fla.),61,10,WIN
2013,Sweet 16,2,Duke,71,3,Michigan State,61,10,WIN
2013,First Round,15,Florida Gulf Coast,78,2,Georgetown,68,10,WIN
2013,Second Round,15,Florida Gulf Coast,81,7,San Diego State,71,10,WIN
2013,First Round,3,Michigan State,65,14,Valparaiso,54,11,WIN
2013,Sweet 16,3,Florida,62,15,Florida Gulf Coast,50,12,WIN
2013,First Round,2,Duke,73,15,Albany (N.Y.),61,12,WIN
2013,Second Round,1,Kansas,70,8,North Carolina,58,12,WIN
2013,First Round,6,Butler,68,11,Bucknell,56,12,WIN
2013,First Round,12,Oregon,68,5,Oklahoma State,55,13,WIN
2013,Second Round,3,Florida,78,11,Minnesota,64,14,WIN
2013,Sweet 16,9,Wichita State,72,13,La Salle,58,14,WIN
2013,First Round,4,Michigan,71,13,South Dakota State,56,15,WIN
2013,Second Round,2,Duke,66,7,Creighton,50,16,WIN
2013,Second Round,12,Oregon,74,4,St. Louis,57,17,WIN
2013,First Round,6,Arizona,81,11,Belmont,64,17,WIN
2013,First Round,10,Iowa State,76,7,Notre Dame,58,18,WIN
2013,First Round,9,Wichita State,73,8,Pittsburgh,55,18,WIN
2013,Elite Eight,4,Michigan,79,3,Florida,59,20,WIN
2013,First Round,11,Minnesota,83,6,UCLA,63,20,WIN
2013,Second Round,3,Michigan State,70,6,Memphis,48,22,WIN
2013,Elite Eight,1,Louisville,85,2,Duke,63,22,WIN
2013,Second Round,6,Arizona,74,14,Harvard,51,23,WIN
2013,Second Round,4,Michigan,78,5,Virginia Commonwealth,53,25,WIN
2013,Second Round,1,Louisville,82,8,Colorado State,56,26,WIN
2013,First Round,2,Miami (Fla.),78,15,Pacific,49,29,WIN
2013,First Round,1,Louisville,79,16,North Carolina A&T,48,31,WIN
2013,First Round,3,Florida,79,14,Northwestern State,47,32,WIN
2013,First Round,5,Virginia Commonwealth,88,12,Akron,42,46,WIN
2014,Second Round,3,Creighton,55,6,Baylor,85,-30,LOSS
2014,Second Round,8,Gonzaga,61,1,Arizona,84,-23,LOSS
2014,First Round,14,North Carolina Central,75,3,Iowa State,93,-18,LOSS
2014,Play-In,12,Xavier,59,12,North Carolina State,74,-15,LOSS
2014,Second Round,2,Villanova,65,7,Connecticut,77,-12,LOSS
2014,Play-In,16,Texas Southern,69,16,Cal-Poly,81,-12,LOSS
2014,Sweet 16,4,UCLA,68,1,Florida,79,-11,LOSS
2014,Final Four,1,Florida,53,7,Connecticut,63,-10,LOSS
2014,Elite Eight,11,Dayton,52,1,Florida,62,-10,LOSS
2014,Second Round,7,Oregon,77,2,Wisconsin,85,-8,LOSS
2014,First Round,9,Oklahoma State,77,8,Gonzaga,85,-8,LOSS
2014,Play-In,16,Mount St. Mary's,64,16,Albany (N.Y.),71,-7,LOSS
2014,First Round,3,Duke,71,14,Mercer,78,-7,LOSS
2014,First Round,9,Kansas State,49,8,Kentucky,56,-7,LOSS
2014,Elite Eight,4,Michigan State,54,7,Connecticut,60,-6,LOSS
2014,National Championship,8,Kentucky,54,7,Connecticut,60,-6,LOSS
2014,Sweet 16,3,Iowa State,76,7,Connecticut,81,-5,LOSS
2014,Sweet 16,4,Louisville,69,8,Kentucky,74,-5,LOSS
2014,First Round,13,New Mexico State,69,4,San Diego State,73,-4,LOSS
2014,First Round,5,Cincinnati,57,12,Harvard,61,-4,LOSS
2014,Second Round,2,Kansas,57,10,Stanford,60,-3,LOSS
2014,Elite Eight,2,Michigan,72,8,Kentucky,75,-3,LOSS
2014,Sweet 16,1,Virginia,59,4,Michigan State,61,-2,LOSS
2014,First Round,11,Providence,77,6,North Carolina,79,-2,LOSS
2014,Second Round,6,North Carolina,83,10,Iowa State,85,-2,LOSS
2014,Second Round,1,Wichita State,76,8,Kentucky,78,-2,LOSS
2014,First Round,5,Virginia Commonwealth,75,12,Stephen F. Austin,77,-2,LOSS
2014,Final Four,2,Wisconsin,73,8,Kentucky,74,-1,LOSS
2014,Elite Eight,1,Arizona,63,2,Wisconsin,64,-1,LOSS
2014,Elite Eight,2,Wisconsin,64,1,Arizona,63,1,WIN
2014,First Round,11,Dayton,60,6,Ohio State,59,1,WIN
2014,Final Four,8,Kentucky,74,2,Wisconsin,73,1,WIN
2014,Sweet 16,4,Michigan State,61,1,Virginia,59,2,WIN
2014,Second Round,10,Iowa State,85,6,North Carolina,83,2,WIN
2014,Sweet 16,2,Michigan,73,11,Tennessee,71,2,WIN
2014,First Round,6,North Carolina,79,11,Providence,77,2,WIN
2014,Second Round,11,Dayton,55,3,Syracuse,53,2,WIN
2014,Second Round,8,Kentucky,78,1,Wichita State,76,2,WIN
2014,Elite Eight,8,Kentucky,75,2,Michigan,72,3,WIN
2014,Sweet 16,8,Kentucky,74,4,Louisville,69,5,WIN
2014,Sweet 16,1,Arizona,70,4,San Diego State,64,6,WIN
2014,Second Round,4,Michigan State,80,12,Harvard,73,7,WIN
2014,First Round,4,Louisville,71,13,Manhattan,64,7,WIN
2014,First Round,8,Kentucky,56,9,Kansas State,49,7,WIN
2014,Second Round,2,Wisconsin,85,7,Oregon,77,8,WIN
2014,First Round,8,Gonzaga,85,9,Oklahoma State,77,8,WIN
2014,First Round,1,Arizona,68,16,Weber State,59,9,WIN
2014,Elite Eight,1,Florida,62,11,Dayton,52,10,WIN
2014,First Round,3,Creighton,76,14,Louisiana-Lafayette,66,10,WIN
2014,Sweet 16,11,Dayton,82,10,Stanford,72,10,WIN
2014,First Round,1,Virginia,70,16,Coastal Carolina,59,11,WIN
2014,Sweet 16,1,Florida,79,4,UCLA,68,11,WIN
2014,First Round,2,Kansas,80,15,Eastern Kentucky,69,11,WIN
2014,First Round,1,Florida,67,16,Albany (N.Y.),55,12,WIN
2014,Second Round,2,Michigan,79,7,Texas,65,14,WIN
2014,First Round,4,Michigan State,93,13,Delaware,78,15,WIN
2014,Second Round,4,Louisville,66,5,St. Louis,51,15,WIN
2014,Second Round,1,Florida,61,9,Pittsburgh,45,16,WIN
2014,Sweet 16,2,Wisconsin,69,6,Baylor,52,17,WIN
2014,First Round,2,Michigan,57,15,Wofford,40,17,WIN
2014,First Round,4,UCLA,76,13,Tulsa,59,17,WIN
2014,Second Round,6,UCLA,77,12,Stephen F. Austin,60,17,WIN
2014,Second Round,1,Virginia,78,8,Memphis,60,18,WIN
2014,First Round,3,Iowa State,93,14,North Carolina Central,75,18,WIN
2014,First Round,7,Oregon,87,10,Brigham Young,68,19,WIN
2014,First Round,2,Villanova,73,15,Milwaukee,53,20,WIN
2014,Second Round,1,Arizona,84,8,Gonzaga,61,23,WIN
2014,First Round,1,Wichita State,64,16,Cal-Poly,37,27,WIN
2014,First Round,2,Wisconsin,75,15,American,35,40,WIN
2015,Sweet 16,5,West Virginia,39,1,Kentucky,78,-39,LOSS
2015,First Round,15,Texas Southern,72,2,Arizona,93,-21,LOSS
2015,Final Four,7,Michigan State,61,1,Duke,81,-20,LOSS
2015,First Round,15,New Mexico State,56,2,Kansas,75,-19,LOSS
2015,Elite Eight,2,Gonzaga,52,1,Duke,66,-14,LOSS
2015,First Round,6,Providence,53,11,Dayton,66,-13,LOSS
2015,Second Round,2,Kansas,65,7,Wichita State,78,-13,LOSS
2015,Second Round,8,Cincinnati,51,1,Kentucky,64,-13,LOSS
2015,Sweet 16,11,UCLA,62,2,Gonzaga,74,-12,LOSS
2015,Sweet 16,7,Wichita State,70,3,Notre Dame,81,-11,LOSS
2015,Second Round,4,Maryland,59,5,West Virginia,69,-10,LOSS
2015,Second Round,5,Arkansas,78,4,North Carolina,87,-9,LOSS
2015,Sweet 16,6,Xavier,60,2,Arizona,68,-8,LOSS
2015,Second Round,8,Oregon,65,1,Wisconsin,72,-7,LOSS
2015,Sweet 16,4,North Carolina,72,1,Wisconsin,79,-7,LOSS
2015,Final Four,1,Kentucky,64,1,Wisconsin,71,-7,LOSS
2015,Elite Eight,2,Arizona,78,1,Wisconsin,85,-7,LOSS
2015,Second Round,2,Virginia,54,7,Michigan State,60,-6,LOSS
2015,First Round,9,Oklahoma State,73,8,Oregon,79,-6,LOSS
2015,Elite Eight,4,Louisville,70,7,Michigan State,76,-6,LOSS
2015,Second Round,11,Dayton,66,3,Oklahoma,72,-6,LOSS
2015,National Championship,1,Wisconsin,63,1,Duke,68,-5,LOSS
2015,Second Round,1,Villanova,68,8,North Carolina State,71,-3,LOSS
2015,Second Round,6,Butler,64,3,Notre Dame,67,-3,LOSS
2015,First Round,7,Virginia Commonwealth,72,10,Ohio State,75,-3,LOSS
2015,Elite Eight,3,Notre Dame,66,1,Kentucky,68,-2,LOSS
2015,First Round,6,Southern Methodist,59,11,UCLA,60,-1,LOSS
2015,First Round,3,Iowa State,59,14,Alabama-Birmingham,60,-1,LOSS
2015,First Round,9,Purdue,65,8,Cincinnati,66,-1,LOSS
2015,First Round,11,UCLA,60,6,Southern Methodist,59,1,WIN
2015,First Round,8,Cincinnati,66,9,Purdue,65,1,WIN
2015,Play-In,11,Dayton,56,11,Boise State,55,1,WIN
2015,First Round,4,Louisville,57,13,UC Irvine,55,2,WIN
2015,First Round,4,North Carolina,67,13,Harvard,65,2,WIN
2015,Elite Eight,1,Kentucky,68,3,Notre Dame,66,2,WIN
2015,First Round,5,Arkansas,56,12,Wofford,53,3,WIN
2015,Second Round,3,Notre Dame,67,6,Butler,64,3,WIN
2015,First Round,4,Maryland,65,13,Valparaiso,62,3,WIN
2015,Sweet 16,7,Michigan State,62,3,Oklahoma,58,4,WIN
2015,First Round,3,Notre Dame,69,14,Northeastern,65,4,WIN
2015,National Championship,1,Duke,68,1,Wisconsin,63,5,WIN
2015,First Round,7,Wichita State,81,10,Indiana,76,5,WIN
2015,Sweet 16,1,Duke,63,5,Utah,57,6,WIN
2015,Second Round,7,Michigan State,60,2,Virginia,54,6,WIN
2015,Elite Eight,7,Michigan State,76,4,Louisville,70,6,WIN
2015,First Round,8,Oregon,79,9,Oklahoma State,73,6,WIN
2015,First Round,5,West Virginia,68,12,Buffalo,62,6,WIN
2015,Second Round,1,Wisconsin,72,8,Oregon,65,7,WIN
2015,Sweet 16,1,Wisconsin,79,4,North Carolina,72,7,WIN
2015,Elite Eight,1,Wisconsin,85,2,Arizona,78,7,WIN
2015,Final Four,1,Wisconsin,71,1,Kentucky,64,7,WIN
2015,First Round,7,Michigan State,70,10,Georgia,63,7,WIN
2015,First Round,6,Butler,56,11,Texas,48,8,WIN
2015,Second Round,6,Xavier,75,14,Georgia State,67,8,WIN
2015,Sweet 16,2,Arizona,68,6,Xavier,60,8,WIN
2015,Second Round,4,North Carolina,87,5,Arkansas,78,9,WIN
2015,Sweet 16,4,Louisville,75,8,North Carolina State,65,10,WIN
2015,First Round,2,Gonzaga,86,15,North Dakota State,76,10,WIN
2015,Second Round,5,West Virginia,69,4,Maryland,59,10,WIN
2015,Sweet 16,3,Notre Dame,81,7,Wichita State,70,11,WIN
2015,First Round,2,Virginia,79,15,Belmont,67,12,WIN
2015,Sweet 16,2,Gonzaga,74,11,UCLA,62,12,WIN
2015,Second Round,4,Louisville,66,5,Northern Iowa,53,13,WIN
2015,First Round,11,Dayton,66,6,Providence,53,13,WIN
2015,Second Round,7,Wichita State,78,2,Kansas,65,13,WIN
2015,Second Round,1,Kentucky,64,8,Cincinnati,51,13,WIN
2015,First Round,1,Wisconsin,86,16,Coastal Carolina,72,14,WIN
2015,Elite Eight,1,Duke,66,2,Gonzaga,52,14,WIN
2015,Second Round,2,Arizona,73,10,Ohio State,58,15,WIN
2015,Second Round,11,UCLA,92,14,Alabama-Birmingham,75,17,WIN
2015,Second Round,1,Duke,68,8,San Diego State,49,19,WIN
2015,First Round,2,Kansas,75,15,New Mexico State,56,19,WIN
2015,Second Round,2,Gonzaga,87,7,Iowa,68,19,WIN
2015,First Round,6,Xavier,76,11,Mississippi,57,19,WIN
2015,Final Four,1,Duke,81,7,Michigan State,61,20,WIN
2015,First Round,2,Arizona,93,15,Texas Southern,72,21,WIN
2015,First Round,1,Kentucky,79,16,Hampton,56,23,WIN
2015,First Round,1,Duke,85,16,Robert Morris,56,29,WIN
2015,Sweet 16,1,Kentucky,78,5,West Virginia,39,39,WIN
2015,First Round,1,Villanova,93,16,Lafayette,52,41,WIN
2016,Second Round,15,Middle Tennessee State,50,10,Syracuse,75,-25,LOSS
2016,Sweet 16,3,Miami (Fla.),69,2,Villanova,92,-23,LOSS
2016,Play-In,11,Vanderbilt,50,11,Wichita State,70,-20,LOSS
2016,Second Round,9,Providence,66,1,North Carolina,85,-19,LOSS
2016,First Round,7,Dayton,51,10,Syracuse,70,-19,LOSS
2016,First Round,6,Seton Hall,52,11,Gonzaga,68,-16,LOSS
2016,First Round,16,Florida Gulf Coast,67,1,North Carolina,83,-16,LOSS
2016,Sweet 16,5,Maryland,63,1,Kansas,79,-16,LOSS
2016,Sweet 16,4,Duke,68,1,Oregon,82,-14,LOSS
2016,Elite Eight,6,Notre Dame,74,1,North Carolina,88,-14,LOSS
2016,First Round,3,West Virginia,56,14,Stephen F. Austin,70,-14,LOSS
2016,Sweet 16,4,Iowa State,71,1,Virginia,84,-13,LOSS
2016,First Round,13,Iona,81,4,Iowa State,94,-13,LOSS
2016,Elite Eight,1,Oregon,68,2,Oklahoma,80,-12,LOSS
2016,First Round,6,Arizona,55,11,Wichita State,65,-10,LOSS
2016,First Round,2,Michigan State,81,15,Middle Tennessee State,90,-9,LOSS
2016,First Round,13,UNC Wilmington,85,4,Duke,93,-8,LOSS
2016,Second Round,9,Butler,69,1,Virginia,77,-8,LOSS
2016,Second Round,11,Wichita State,57,3,Miami (Fla.),65,-8,LOSS
2016,First Round,11,Michigan,63,6,Notre Dame,70,-7,LOSS
2016,Elite Eight,1,Virginia,62,10,Syracuse,68,-6,LOSS
2016,Second Round,4,Kentucky,67,5,Indiana,73,-6,LOSS
2016,Sweet 16,7,Wisconsin,56,6,Notre Dame,61,-5,LOSS
2016,Elite Eight,1,Kansas,59,2,Villanova,64,-5,LOSS
2016,First Round,12,South Dakota State,74,5,Maryland,79,-5,LOSS
2016,Second Round,10,Virginia Commonwealth,81,2,Oklahoma,85,-4,LOSS
2016,National Championship,1,North Carolina,74,2,Villanova,77,-3,LOSS
2016,Sweet 16,11,Gonzaga,60,10,Syracuse,63,-3,LOSS
2016,Second Round,2,Xavier,63,7,Wisconsin,66,-3,LOSS
2016,First Round,5,Purdue,83,12,Arkansas-Little Rock,85,-2,LOSS
2016,First Round,9,Cincinnati,76,8,St. Joseph's,78,-2,LOSS
2016,First Round,8,Southern California,69,9,Providence,70,-1,LOSS
2016,First Round,9,Providence,70,8,Southern California,69,1,WIN
2016,Second Round,6,Notre Dame,76,14,Stephen F. Austin,75,1,WIN
2016,National Championship,2,Villanova,77,1,North Carolina,74,3,WIN
2016,Second Round,7,Wisconsin,66,2,Xavier,63,3,WIN
2016,First Round,7,Wisconsin,47,10,Pittsburgh,43,4,WIN
2016,Elite Eight,2,Villanova,64,1,Kansas,59,5,WIN
2016,Second Round,1,Oregon,69,8,St. Joseph's,64,5,WIN
2016,Play-In,11,Michigan,67,11,Tulsa,62,5,WIN
2016,Sweet 16,6,Notre Dame,61,7,Wisconsin,56,5,WIN
2016,First Round,5,Maryland,79,12,South Dakota State,74,5,WIN
2016,Second Round,4,Duke,71,12,Yale,64,7,WIN
2016,First Round,3,Miami (Fla.),79,14,Buffalo,72,7,WIN
2016,First Round,6,Notre Dame,70,11,Michigan,63,7,WIN
2016,Second Round,1,Virginia,77,9,Butler,69,8,WIN
2016,First Round,4,Duke,93,13,UNC Wilmington,85,8,WIN
2016,Second Round,3,Miami (Fla.),65,11,Wichita State,57,8,WIN
2016,First Round,10,Virginia Commonwealth,75,7,Oregon State,67,8,WIN
2016,First Round,15,Middle Tennessee State,90,2,Michigan State,81,9,WIN
2016,First Round,9,Butler,71,8,Texas Tech,61,10,WIN
2016,First Round,11,Wichita State,65,6,Arizona,55,10,WIN
2016,Second Round,1,Kansas,73,9,Connecticut,61,12,WIN
2016,Sweet 16,1,Virginia,84,4,Iowa State,71,13,WIN
2016,First Round,4,Iowa State,94,13,Iona,81,13,WIN
2016,Second Round,5,Maryland,73,13,Hawaii,60,13,WIN
2016,Sweet 16,1,Oregon,82,4,Duke,68,14,WIN
2016,Elite Eight,1,North Carolina,88,6,Notre Dame,74,14,WIN
2016,Sweet 16,1,North Carolina,101,5,Indiana,86,15,WIN
2016,Sweet 16,1,Kansas,79,5,Maryland,63,16,WIN
2016,First Round,1,North Carolina,83,16,Florida Gulf Coast,67,16,WIN
2016,First Round,11,Gonzaga,68,6,Seton Hall,52,16,WIN
2016,Second Round,4,Iowa State,78,12,Arkansas-Little Rock,61,17,WIN
2016,Final Four,1,North Carolina,83,10,Syracuse,66,17,WIN
2016,First Round,2,Xavier,71,15,Weber State,53,18,WIN
2016,Second Round,2,Villanova,87,7,Iowa,68,19,WIN
2016,Second Round,1,North Carolina,85,9,Providence,66,19,WIN
2016,Play-In,11,Wichita State,70,11,Vanderbilt,50,20,WIN
2016,Sweet 16,2,Villanova,92,3,Miami (Fla.),69,23,WIN
2016,Second Round,11,Gonzaga,82,3,Utah,59,23,WIN
2016,First Round,1,Kansas,105,16,Austin Peay,79,26,WIN
2016,First Round,4,Kentucky,85,13,Stony Brook,57,28,WIN
2016,First Round,2,Villanova,86,15,UNC Asheville,56,30,WIN
2016,Play-In,16,Florida Gulf Coast,96,16,Fairleigh Dickinson,65,31,WIN
2016,First Round,1,Virginia,81,16,Hampton,45,36,WIN
2016,First Round,1,Oregon,91,16,Holy Cross,52,39,WIN
2016,Final Four,2,Villanova,95,2,Oklahoma,51,44,WIN